[console_scripts]
gnr = gnr.core.cli.gnr:main
gnraddprojectrepo = gnr.dev.cli.gnraddprojectrepo:main
gnrasync = gnr.app.cli.gnrasync:main
gnrdaemon = gnr.web.cli.gnrdaemon:main
gnrdbgraph = gnr.dev.cli.gnrdbgraph:main
gnrdbsetup = gnr.app.cli.gnrdbsetup:main
gnrdbsetupparallel = gnr.app.cli.gnrdbsetupparallel:main
gnrdbshell = gnr.app.cli.gnrdbshell:main
gnrdbstruct = gnr.dev.cli.gnrdbstruct:main
gnrdeploybuilder = gnr.app.cli.gnrdeploybuilder:main
gnrheartbeat = gnr.app.cli.gnrheartbeat:main
gnrlocalizer = gnr.dev.cli.gnrlocalizer:main
gnrmkapachesite = gnr.app.cli.gnrmkapachesite:main
gnrmkinstance = gnr.dev.cli.gnrmkinstance:main
gnrmkpackage = gnr.dev.cli.gnrmkpackage:main
gnrmkproject = gnr.dev.cli.gnrmkproject:main
gnrmksite = gnr.dev.cli.gnrmksite:main
gnrmkthresource = gnr.dev.cli.gnrmkthresource:main
gnrnotes = gnr.dev.cli.gnrnotes:main
gnrremotebagserve = gnr.app.cli.gnrremotebagserve:main
gnrrms = gnr.app.cli.gnrrms:main
gnrsendmail = gnr.app.cli.gnrsendmail:main
gnrserviceworker = gnr.app.cli.gnrserviceworker:main
gnrsitelocalize = gnr.dev.cli.gnrsitelocalize:main
gnrsql2py = gnr.dev.cli.gnrsql2py:main
gnrsync4d = gnr.xtnd.cli.gnrsync4d:main
gnrsync4dpyro = gnr.xtnd.cli.gnrsync4dpyro:main
gnrsyncstorage = gnr.web.cli.gnrsyncstorage:main
gnrtaskscheduler = gnr.web.cli.gnrtaskscheduler:main
gnrtaskworker = gnr.web.cli.gnrtaskworker:main
gnrtrdaemon = gnr.app.cli.gnrtrdaemon:main
gnrupdate = gnr.app.cli.gnrupdate:main
gnrwsgiserve = gnr.web.cli.gnrwsgiserve:main
gnrxml2py = gnr.dev.cli.gnrxml2py:main
initgenropy = gnr.app.cli.initgenropy:main
