i	ik	noncompletion	17
i	is	noncompletion	4
toe	toen	noncompletion	1
toe	sg	explanation	1
toe	doe	replacement	1
tat	dat	replacement	3
tat	want	replacement	1
daain	daarin	noncompletion	2
tie	hij	replacement	5
tie	die	replacement	2
toen	doen	replacement	2
asjebies	alsjeblieft	replacement	1
mas	mag	replacement	4
teet	zeep	replacement	1
ies	iets	noncompletion	2
niw	wil	replacement	1
waa	waar	noncompletion	1
tee	zeep	replacement	8
jaatu	water	replacement	1
hiejin	hierin	replacement	1
sjiw	wil	replacement	1
taat	slaat	explanation	1
taat	staart	explanation	1
taat	staat	replacement	1
taat	gehaald	replacement	1
taat	gaat	replacement	1
hewu	hebben	replacement	1
hee	heel	noncompletion	2
hee	weer	replacement	2
hee	heef	noncompletion	1
hee	een	replacement	1
heew	heel	replacement	6
houtu	grote	replacement	1
waatu	wagen	replacement	1
pakken	gepakt	replacement	1
jeesoo	lego	replacement	1
kee	keer	noncompletion	2
kee	geen	replacement	1
sa	anders	replacement	2
sa	van	replacement	1
ein	erin	noncompletion	1
dument	cement	replacement	1
takdoeku	zakdoek	replacement	1
oot	ook	replacement	2
maa	maar	noncompletion	6
maa	maak	noncompletion	1
nie	niet	noncompletion	13
nie	Leonie	noncompletion	1
heet	weet	replacement	2
u	het	replacement	4
u	een	replacement	4
u	hij	replacement	1
u	op	replacement	1
u	ik	replacement	3
ti	zit	replacement	1
tiej	vier	replacement	1
da	dat	noncompletion	37
da	dan	noncompletion	6
da	te	replacement	1
da	daar	noncompletion	1
oo	ook	noncompletion	3
tijken	kijken	replacement	1
hie	hier	noncompletion	5
hiein	hierin	noncompletion	1
tan	dan	replacement	3
tan	kan	replacement	6
it	ik	replacement	2
nowug	nodig	replacement	1
nowas	nodig	replacement	1
nowus	nodig	replacement	1
too	voor	replacement	1
tit	dit	replacement	3
tij	zij	replacement	1
teep	zeep	replacement	1
kas	kast	noncompletion	1
dich	dicht	noncompletion	2
diehoek	driehoek	noncompletion	1
choenen	schoenen	noncompletion	1
daa	daar	noncompletion	17
stawbewie	strawberry	replacement	1
tuife	druiven	replacement	1
boejij	boerderij	replacement	1
ikke	ik	replacement	7
fajeke	varken	replacement	1
paadje	paardje	noncompletion	2
schaapje	schaapje	replacement	1
wi	kwil	noncompletion	1
wi	wil	noncompletion	1
ees	eerst	replacement	2
ees	eens	noncompletion	1
s	is	noncompletion	39
boe	boer	noncompletion	2
t	het	noncompletion	102
t	met	noncompletion	1
taa	daar	replacement	1
ope	open	noncompletion	1
swaa	zwaar	replacement	1
lalle	ladder	replacement	2
gaatie	gaat ie	replacement	1
bea	beer	replacement	1
pajasow	parasol	replacement	1
waket	raket	replacement	1
baw	bal	replacement	1
bofu	boven	replacement	1
teddy	teddybeer	replacement	1
wa	had	replacement	1
wa	wat	noncompletion	2
moete	moet	replacement	4
e	even	explanation	3
e	'n	replacement	3
e	een	noncompletion	2
e	de	noncompletion	6
e	het	noncompletion	3
e	er	noncompletion	8
e	en	noncompletion	4
e	ze	noncompletion	2
pele	spelen	noncompletion	3
kinneboejij	kinderboerderij	replacement	1
fogo	vogel	replacement	2
siko	cirkel	replacement	1
bjokje	blokje	replacement	1
kikke	kikker	noncompletion	1
springe	springen	noncompletion	1
in	met	replacement	1
in	erin	noncompletion	3
in	deze	replacement	2
in	op	replacement	2
in	uit	replacement	1
in	bij	replacement	2
tactor	tractor	noncompletion	2
op	erop	replacement	5
op	in	replacement	1
die	ze	replacement	2
die	dat	replacement	3
die	het	replacement	1
die	hij	replacement	1
die	daar	replacement	2
z'n	zijn	replacement	4
n	een	noncompletion	99
no	nog	noncompletion	2
draan	deraan	noncompletion	1
kom	komt	noncompletion	4
fiet	fietst	noncompletion	1
chuiven	schuiven	noncompletion	1
ander	anders	noncompletion	1
kaat	gaan	replacement	1
te	ze	replacement	1
te	de	replacement	1
tiern	dieren	replacement	1
dr	haar	explanation	1
dr	der	noncompletion	2
nerke	nergens	replacement	1
kij	kijk	noncompletion	1
fftje	eventjes	replacement	1
trarpje	trappetje	replacement	1
parasel	parasol	replacement	1
k	ik	noncompletion	8
wee	weet	noncompletion	1
wee	alleen	replacement	1
wortjes	worstjes	replacement	1
wortje	worstje	replacement	1
asjeblief	alsjeblieft	replacement	1
ha	ga	replacement	3
ew	er	replacement	2
naaw	naar	replacement	8
wewk	werk	replacement	1
Jatteliene	Jacqueline	replacement	1
daaw	daar	replacement	2
haat	gaat	replacement	2
ie	hij	replacement	20
ie	de	replacement	3
ie	die	noncompletion	4
ie	in	replacement	1
ie	gaat ie	explanation	1
jo	zo	replacement	1
weew	weer	replacement	5
dankie	dank je	replacement	1
hewpen	helpen	replacement	1
hiew	hier	replacement	5
maaw	maar	replacement	1
lekkew	lekker	replacement	1
watew	water	replacement	1
annews	anders	replacement	1
waaw	waar	replacement	1
ojifant	olifant	replacement	1
Afwika	Afrika	replacement	1
pas	past	noncompletion	1
oppelost	opgelost	replacement	1
alweew	alweer	replacement	1
naawtoe	naartoe	replacement	1
hebbe	hebben	noncompletion	1
dees	hierin	replacement	2
dees	deze	replacement	12
em	hem	noncompletion	3
tuurlijk	natuurlijk	noncompletion	1
heb	hebben	replacement	3
heb	heeft	replacement	2
heb	heet	replacement	1
heb	hebt	noncompletion	4
heb	is	replacement	1
hebt	heeft	replacement	3
hebt	heb	replacement	1
zitte	zitten	noncompletion	1
deruit	eruit	replacement	1
moe	moet	noncompletion	10
kan	kunnen	replacement	1
kan	kam	explanation	1
kan	dan	replacement	2
deeske	deze	replacement	5
ke	de	replacement	7
ke	die	replacement	1
dese	deze	replacement	4
hijs	hij is	replacement	1
eigk	eigenlijk	replacement	1
de	het	replacement	23
de	zitten	replacement	1
de	der	noncompletion	11
de	dan	replacement	2
de	deze	replacement	2
moek	moet	replacement	2
rijken	rijden	replacement	1
turen	sturen	noncompletion	2
gwoon	gewoon	noncompletion	2
deke	deze	replacement	1
keraf	eraf	replacement	1
keke	deze	replacement	1
sakhoue	vasthouden	replacement	1
opraaien	opdraaien	noncompletion	1
koch	toch	replacement	1
kat	dat	replacement	1
wak	wat	replacement	1
tuur	stuur	noncompletion	1
kok	ook	replacement	1
pobreren	proberen	replacement	1
ze	zit	explanation	3
ze	hem	replacement	1
ze	zijn	replacement	2
derin	erin	replacement	1
aardbeiijs	aardbeienijs	replacement	1
kijke	kijken	noncompletion	1
deraf	eraf	replacement	1
gaat	laat	replacement	2
gaat	zegt	replacement	1
gaat	ga	replacement	1
memen	meenemen	replacement	1
ka	kan	noncompletion	1
opronnu	oprollen	replacement	1
ig	ik	replacement	1
mewk	melk	replacement	1
worst	borst	replacement	1
ennu	en	replacement	1
koeie	koeien	noncompletion	1
o	op	noncompletion	3
mij	mijn	noncompletion	10
bet	bent	noncompletion	1
bent	ben	replacement	1
tinnen	tillen	replacement	1
emaakt	gemaakt	noncompletion	2
papot	kapot	replacement	1
uithanen	uithalen	replacement	1
emaak	gemaakt	noncompletion	1
pakot	kapot	replacement	1
si	sit	noncompletion	1
fas	fast	noncompletion	1
wil	wiel	noncompletion	1
wiew	wiel	replacement	1
gron	grond	noncompletion	1
dlupo	duplo	replacement	1
ukeerde	verkeerde	replacement	1
edaa	gedaan	noncompletion	1
tu	toch	replacement	1
tu	dan	replacement	1
wiw	wil	replacement	1
naan	banaan	explanation	3
es	eens	noncompletion	57
m	hem	noncompletion	16
wilt	wil	replacement	4
taan	staan	explanation	3
jijjen	rijden	replacement	2
zn	zijn	noncompletion	4
maken	aan elkaar	explanation	2
hu	pronoun	explanation	1
man	de kassier	explanation	1
leeuw	leeuwe	noncompletion	1
ditte	dit	replacement	3
d'aan	eraan	replacement	3
brbrbrbr	motorgeluiden	explanation	2
mn	mijn	noncompletion	7
omt	komt	explanation	4
an	kan	explanation	2
kleppie	klepje	replacement	3
pusses	puzzelstukjes	explanation	3
gane	gaan	replacement	3
puss	puzzelen	replacement	3
dietuin	dierentuin	explanation	3
tein	trein	noncompletion	6
kimmen	klimmen	explanation	3
ma	mag	explanation	6
klei	kleine	explanation	3
karrebeertjes	koalabeertjes	explanation	3
dit	deze	explanation	3
pisa	pistool	explanation	3
maat	tomaat	explanation	3
we	bewegen	explanation	6
plassijde	bladzijde	explanation	3
konij	konijn	explanation	1
haatjes	haartjes	explanation	1
lape	slapen	explanation	4
laapkamer	slaapkamer	noncompletion	2
saat	gaat	explanation	4
kool	goal	explanation	1
kersie	kersje	explanation	1
anne	andere	explanation	7
ee	een	noncompletion	9
step	schep	replacement	4
isse	is	replacement	2
isse	is 'n	explanation	1
stepje	schepje	explanation	1
wos	worst	explanation	1
kokool	stoffer	explanation	1
boot	vlag	explanation	1
rado	radio	explanation	2
poese	poesje	noncompletion	3
kijt	krijt	noncompletion	3
mette	met	replacement	5
gooie	gooien	noncompletion	3
cende	centjes	replacement	3
oppe	in	replacement	3
zotes	grote	explanation	1
burg	berg	explanation	1
saapt	slaapt	explanation	2
inne	de	replacement	2
inne	naar	replacement	2
jafel	tafel	replacement	2
vief	lief	explanation	1
gote	grote	explanation	1
deutje	deurtje	explanation	2
jerke	werk	replacement	2
ite	niet	replacement	2
ansie	vakantie	replacement	2
af	is eraf	explanation	2
af	eraf	noncompletion	2
af	kan eraf	explanation	1
afgewoke	afgebroken	explanation	1
teintje	treintje	noncompletion	2
di's	dit	replacement	2
oote	grote	replacement	2
jantauto	brandweerauto	replacement	1
annetje	mannetje	explanation	1
toot	boot	explanation	2
toot	grote boot	explanation	1
soeie	roeien	explanation	1
tuk	stuk	noncompletion	4
eze	deze	noncompletion	1
hatel	gaat	replacement	1
el	gaat wel	explanation	1
e'af	moet eraf	explanation	1
chep	schelp	explanation	2
borsel	borstel	noncompletion	2
slarties	Smarties	explanation	2
varkje	varkentje	explanation	2
wor	word	explanation	2
een	'n	explanation	2
een	de	replacement	1
't	wat	explanation	2
hijgen	hijsen	explanation	1
tuperman	Superman	explanation	1
kijna	bijna	explanation	1
klaan	kraan	explanation	1
voorstee	schoorsteen	explanation	2
knorrens	varkens	explanation	1
kein	klein	explanation	1
ooid	gegooid	explanation	1
lullie	jullie	explanation	1
ooien	gooien	explanation	1
luiers	Arjen	replacement	2
Arjen	luiers	replacement	2
tree	twee	explanation	1
deze	dit	replacement	4
deze	waar hoort deze	explanation	1
evallen	gevallen	noncompletion	1
nog	ook	explanation	1
voor	bij	replacement	1
voor	om	replacement	2
voor	van	explanation	1
wat	waar	replacement	2
wordt	hoort	replacement	2
wordt	worden	replacement	1
di	dit	noncompletion	4
meeenoomt	meegenoomt	noncompletion	1
kregen	gekregen	noncompletion	2
wegge	weggetje	noncompletion	1
pelletje	spelletje	noncompletion	1
pot	kapot	noncompletion	4
maakt	deed	replacement	1
maakt	gemaakt	noncompletion	3
tien	Christien	noncompletion	3
kiepen	omkiepen	noncompletion	1
speeld	gespeeld	noncompletion	2
tekker	trekker	explanation	2
nijnties	konijnen	explanation	1
daaro	daarop	noncompletion	1
stapt	gestapt	noncompletion	1
wintik	winkel	replacement	1
me	met	noncompletion	1
me	maar	replacement	1
me	mijn	explanation	1
me	we	replacement	7
melluk	melk	replacement	1
et	het	noncompletion	5
mee	gaat hij mee	explanation	2
mee	meer	noncompletion	3
mee	met	replacement	1
eers	eerst	noncompletion	4
voorleze	voorlezen	noncompletion	1
knippe	knippen	noncompletion	1
welə	welles	replacement	1
almaal	allemaal	noncompletion	1
ginge	gingen	noncompletion	4
ete	eten	noncompletion	1
macoroni	macaroni	explanation	1
macaronien	macaroni	explanation	1
spele	spelen	noncompletion	1
binne	binnen	noncompletion	1
eve	even	noncompletion	1
gaa	gaan	noncompletion	2
gaa	gaat	noncompletion	1
stoppe	verstoppen	noncompletion	1
vonde	vonden	noncompletion	2
drinke	drinken	noncompletion	1
j	jij	noncompletion	1
vertelle	vertellen	noncompletion	2
losmak	losmaken	noncompletion	1
loshouen	loshouden	noncompletion	1
geworde	geworden	noncompletion	1
reuse	reuzen	replacement	1
wippen	wip	replacement	2
heen	overheen	noncompletion	2
waagtjes	wagentjes	replacement	2
stitten	zitten	replacement	2
loop	lopen	replacement	2
stapel	stapelbed	noncompletion	3
staap	stapelbed	replacement	2
tomme	komt	replacement	2
pasten	pesten	explanation	1
pantoet	pannekoeken	replacement	2
eet	eten	replacement	2
bejo	hallo	explanation	1
teje	gaan	replacement	2
maar	normaal	replacement	1
maar	en	replacement	7
maar	want	replacement	1
maar	ga daar maar	explanation	1
tappe	stap	replacement	2
tom	komt	replacement	2
tom	soms	replacement	1
totedil	krokodil	replacement	2
he	muts	explanation	3
he	het	noncompletion	2
he	heb	noncompletion	1
ga	gaat	noncompletion	5
ga	gaan	replacement	4
veven	geven	explanation	3
moven	weg	replacement	7
choot	schoot	explanation	9
poppe	muts	replacement	3
mus	van	replacement	3
mus	muts	explanation	3
anner	andere	explanation	3
ja	op straat	explanation	3
see	sneeuw	explanation	3
vallen	gevallen	explanation	3
tasje	bedje	explanation	3
begbengen	wegbrengen	explanation	6
dzo	zo	explanation	1
bochje	bochtje	explanation	1
anders	andere	explanation	1
saar	daar	explanation	1
saal	haal	explanation	1
saan	gaan	replacement	2
bruiken	gebruiken	explanation	1
keerd	verkeerd	explanation	1
vrastauto	vrachtauto	replacement	1
mooi	mooie	noncompletion	1
siets	fiets	replacement	1
make	maken	noncompletion	7
so	zo	replacement	8
boseop	bovenop	replacement	5
fa	fan	noncompletion	1
fa	van	replacement	1
daana	daarna	noncompletion	3
bouwe	bouwen	noncompletion	9
soot	groot	replacement	1
saks	straks	noncompletion	1
nos	nog	replacement	2
boos	bovenop	replacement	1
boo	bovenop	replacement	2
sits	zitten	replacement	1
kga	ikga	noncompletion	1
seppe	scheppen	noncompletion	1
sjep	schep	replacement	1
buite	buiten	noncompletion	1
hare	haren	noncompletion	1
kamme	kammen	noncompletion	2
trees	twee	explanation	1
Jona	jongen	explanation	2
wast	was	explanation	1
hang	hangen	explanation	1
wasde	was	explanation	1
rijs	Parijs	noncompletion	1
waarhee	waarheen	noncompletion	1
dez	deze	noncompletion	1
ieduleen	iedereen	replacement	2
lettu	redden	replacement	2
uitkijktoolu	uitkijktoren	replacement	2
saafu	graven	replacement	2
wate	water	noncompletion	2
siesu	vliegen	replacement	2
had	hard	noncompletion	4
had	gehad	replacement	1
had	kon	replacement	1
leen	aleen	noncompletion	2
leen	alleen	replacement	3
gun	ging	replacement	2
gin	ging	noncompletion	4
som	soms	noncompletion	6
witte	wit	replacement	2
dee	deed	noncompletion	1
dee	was	replacement	2
dan	toen	replacement	6
ging	gingen	replacement	2
Cas	Cars	noncompletion	8
speeloet	speelgoed	replacement	2
Cwas	Cwars	noncompletion	2
siend	vriend	replacement	2
hoo	hoor	noncompletion	2
debij	derbij	noncompletion	4
wuw	wil	replacement	2
Eipet	iPad	replacement	2
om	op	replacement	2
mat	mag het	replacement	2
Ensu	Enzo	replacement	2
Slow	Knol	replacement	2
pulletjes	spulletjes	noncompletion	2
hellu	willen	replacement	2
teesjut	tieshirt	replacement	2
dikku	sticker	replacement	2
soe	zo	replacement	2
Misjie	Marshall	replacement	2
Pot	Porter	replacement	2
ky	Sky	noncompletion	2
sewf	zelf	replacement	2
sas	zag	replacement	4
lew	wel	replacement	2
slin	ging	replacement	2
stond	stonden	replacement	4
stond	was	replacement	2
van	bij	replacement	2
van	om	replacement	2
van	door	replacement	1
van	met	replacement	1
van	uit	replacement	1
van	veel	replacement	1
arreen	alleen	replacement	2
het	er	replacement	2
het	hij	replacement	2
jiggen	liggen	replacement	4
kruisd	gekruisd	replacement	2
jit	ligt	replacement	2
riggen	liggen	replacement	2
hel	wel	replacement	2
rigt	ligt	replacement	2
mog	nog	replacement	2
harders	harder	replacement	2
is	gaat	replacement	2
allerlangzaam	allerlangzaamste	replacement	2
his	wist	replacement	2
bij	op	replacement	2
bij	voor	replacement	1
sumdat	voordat	replacement	2
nieuw	nieuwe	noncompletion	2
gezon	gezonde	replacement	2
moes	moest	noncompletion	9
rege	leeg	replacement	2
denk	denkt	noncompletion	1
opgeten	opgegeten	replacement	1
kunnen	kan	replacement	1
gingen	ging	replacement	2
doen	duikelen	replacement	1
slur	slurf	noncompletion	1
badje	zwemmen	replacement	1
verkopen	vragen	replacement	1
voetbalmeester	trainer	replacement	2
daar	waar	replacement	2
daar	dan	replacement	1
daar	gaat	replacement	1
twemle	twemles	noncompletion	1
twemles	zwemles	replacement	1
poberen	proberen	noncompletion	1
vliegen	fladderen	replacement	1
as	als	noncompletion	1
as	dat	replacement	1
echt	echte	noncompletion	2
gezie	gezien	noncompletion	1
vader	vaders	noncompletion	1
hoger	ouder	replacement	1
net	met	replacement	3
datte	wat	replacement	1
moet	moeten	replacement	3
als	of	replacement	2
als	waarmee	replacement	1
hardte	hardste	noncompletion	1
want	en	replacement	1
want	als	replacement	1
gaan	gegaan	replacement	1
gaan	gingen	replacement	1
slaapten	sliepen	replacement	2
slaapte	sliep	replacement	1
zaten	hadden	replacement	1
zo	zo'n	replacement	1
ook	blauwe ramen zitten er ook	explanation	1
ginnen	gingen	replacement	2
dat	daar	replacement	1
dat	het	replacement	1
allegrooste	allegrootste	noncompletion	2
en	maar	replacement	3
en	eng	noncompletion	1
en	want	replacement	2
ben	wordt	replacement	2
pupcakes	cupcakes	replacement	1
pupcakedingetjes	cupcakedingetjes	replacement	1
vom	vorm	noncompletion	2
doet	doe	replacement	1
lus	lust	noncompletion	2
babykijn	babykonijn	replacement	1
babynijn	babykonijn	replacement	1
poep	poept	noncompletion	1
kinderboererij	kinderboerderij	noncompletion	1
vin	vind	noncompletion	2
vin	vindt	noncompletion	2
kinerboererij	kinderboerderij	noncompletion	1
woon	gewoon	replacement	7
blijf	blijft	noncompletion	1
tof	toch	replacement	2
blijven	blijft	replacement	1
sieten	sgieten	noncompletion	1
ta	tat	noncompletion	1
peltje	pijltje	replacement	1
pijwtje	pijltje	replacement	1
sef	zeg	replacement	1
doe	toen	replacement	1
doe	ga	replacement	1
zwaarden	vechten	replacement	1
lekkes	lekkers	noncompletion	1
was	ging	replacement	1
was	waren	replacement	1
was	wat	replacement	1
suimpjes	sguimpjes	noncompletion	1
foot	grote	replacement	1
foot	groot	replacement	1
fan	als	replacement	1
suimpje	sguimpje	noncompletion	3
flij	vrij	replacement	1
lekke	lekker	noncompletion	1
sool	sgool	noncompletion	1
weken	werken	noncompletion	1
allee	alleen	noncompletion	1
kleulen	kleuren	replacement	1
paatje	paartje	noncompletion	1
sintetlaaspaatje	sinterklaaspaardje	replacement	1
Zwatepiet	Zwartepiet	noncompletion	1
saf	staf	noncompletion	1
kippes	kippies	replacement	2
itten	eten	replacement	2
ziekje	muziekje	replacement	1
Bobdebouwerkattet	Bobdebouwerkwartet	replacement	1
blazen	geblazen	replacement	1
ik	je	replacement	1
ik	jij	replacement	1
ik	mij	replacement	1
wou	wilde	replacement	3
vashouden	vasthouden	noncompletion	2
tant	want	replacement	2
aws	alles	replacement	4
taar	klaar	replacement	2
neezetten	neerzetten	noncompletion	2
dootassen	doorkrassen	replacement	2
amus	anders	replacement	2
bes	best	noncompletion	2
goot	groot	noncompletion	2
wew	wel	replacement	2
ij	hij	noncompletion	6
dudieping	verdieping	replacement	4
elukkig	gelukkig	noncompletion	2
beut	beurt	noncompletion	2
ra	wat	replacement	2
beurt	gebeurt	replacement	2
ston	stond	noncompletion	2
gewoo	gewoon	noncompletion	2
awes	alles	replacement	2
taag	graag	replacement	2
du	dus	noncompletion	2
waampjes	raampjes	replacement	2
boveop	bovenop	noncompletion	2
kon	konden	replacement	2
niet	geen	replacement	4
naa	naar	noncompletion	4
muneedu	beneden	replacement	2
fietsenpaats	fietsenplaats	noncompletion	2
has	waren	replacement	2
naas	naast	noncompletion	2
leet	weet	replacement	2
va	van	noncompletion	2
ukope	verkoper	replacement	2
fu	van	replacement	2
hat	wat	replacement	2
ting	ging	replacement	2
ukopen	verkopen	replacement	2
awus	alles	replacement	2
opjuuter	computer	replacement	2
hupot	kapot	replacement	2
fingen	gingen	replacement	2
jeddu	verder	replacement	2
tis	wist	replacement	2
tapitein	kapitein	replacement	2
a	als	replacement	2
a	al	noncompletion	2
vawt	valt	replacement	2
hoet	goed	replacement	2
boem	bodem	noncompletion	4
onde	onder	noncompletion	2
fobolt	bijvoorbeeld	replacement	2
aem	adem	noncompletion	3
kie	keer	replacement	2
semmen	zwemmen	replacement	2
semmen	swemmen	noncompletion	4
wemmen	swemmen	noncompletion	2
spellejes	spelletjes	noncompletion	2
stem	zwem	replacement	2
jiejie	jullie	replacement	2
lij	wij	replacement	2
deuit	deruit	noncompletion	2
heer	weer	replacement	2
tiemen	klimmen	replacement	2
amaa	amaal	noncompletion	2
eer	weer	noncompletion	2
keetje	keertje	noncompletion	2
hepen	helpen	noncompletion	2
hopij	voorbij	replacement	2
daahom	waarom	replacement	2
hapjoetu	computer	replacement	2
kame	kamer	noncompletion	2
ondekant	onderkant	noncompletion	2
ebij	erbij	noncompletion	2
Spakeburg	Spakenburg	noncompletion	1
dsjie	keer	replacement	1
baboogam	bubblegum	replacement	2
hun	zij	replacement	1
dag	overdag	replacement	1
verplaatst	veranderd	replacement	1
gedaan	gebouwd	replacement	2
gedaan	gemaakt	replacement	1
heef	heeft	noncompletion	4
heu	heel	replacement	3
veul	veel	replacement	1
bloed	bloeden	replacement	1
zij	zijn	noncompletion	1
bloeten	bloeden	replacement	1
waar	maar	replacement	1
beem	been	replacement	1
haal	haalt	noncompletion	1
deaf	deraf	noncompletion	1
heul	heel	replacement	1
onsnapt	ontsnapt	noncompletion	1
hij	er	replacement	2
glijbaans	glijbanen	replacement	1
morgen	volgende	replacement	1
konijnennoepjes	konijnensnoepjes	replacement	1
konijnennoepje	konijnensnoepje	replacement	2
meng	neem	replacement	1
zeg	zegt	replacement	2
teftef	detective	replacement	2
coachen	coacht	replacement	1
rat	wrat	replacement	1
zembril	zwembril	replacement	1
chool	school	replacement	2
til	stil	replacement	1
tukmaken	stukmaken	replacement	2
silderij	schilderij	replacement	2
ottetreken	optreden	replacement	1
bruikt	gebruikt	replacement	1
taart	staart	replacement	1
pelen	spelen	replacement	4
slijbaan	glijbaan	replacement	1
anre	anderen	replacement	1
tekelen	tekenen	replacement	1
daag	vandaag	replacement	1
filmp	film	replacement	1
woedag	woensdag	replacement	1
keihan	keihard	replacement	1
kont	komt	replacement	1
kleiner	kleinere	noncompletion	1
aan	in	replacement	1
hem	zijn	replacement	1
misschaan	misschien	replacement	1
draai	draait	noncompletion	1
zaag	zagen	replacement	1
viel	valt	replacement	1
omme	omdat	replacement	1
kun	kunnen	replacement	1
alse	als	replacement	1
rekele	rekenen	replacement	1
daarzo	daar	replacement	1
voorbeeld	bijvoorbeeld	replacement	1
freene	free-runnen	replacement	1
x	racen-x	replacement	1
x	los ?	replacement	1
x	gelaten ?	replacement	1
x	gewoon	replacement	1
feerunnen	freerunnen	replacement	1
wees	geweest	replacement	1
schien	misschien	replacement	2
woonb	gewoon	replacement	1
sjale	speciale	replacement	1
zorgen	verzorgen	replacement	1
kantie	vakantie	replacement	1
zomerkantie	vakantie	replacement	1
boekje	'n boekje voor David	explanation	1
xxx	?	replacement	1
koppie	kopbal	replacement	1
weer	meer	replacement	1
kubbelbum	bubblegum ?	replacement	1
probreren	proberen	replacement	2
doem	doen	replacement	1
durf	durft	noncompletion	1
tik	tikkertje	replacement	1
teek	betekent	replacement	1
palaplu	paraplu	replacement	1
valaag	vandaag	replacement	1
,	dat	replacement	1
tegen	aan	replacement	1
zeggen	vragen	replacement	1
vliegtuig	vliegveld	replacement	1
anneen	alleen	replacement	1
na	dan	replacement	1
noen	doen	replacement	1
teeëndertig	tweeëndertig	replacement	1
