[console_scripts]
duploctl = duplocloud.cli:main

[duplocloud.net]
ai = duplo_resource.ai:DuploAI
asg = duplo_resource.asg:DuploAsg
aws_secret = duplo_resource.aws_secret:DuploAwsSecret
batch_compute = duplo_resource.batch_compute:DuploBatchCompute
batch_definition = duplo_resource.batch_definition:DuploBatchDefinition
batch_job = duplo_resource.batch_job:DuploBatchJob
batch_queue = duplo_resource.batch_queue:DuploBatchQueue
batch_scheduling_policy = duplo_resource.batch_scheduling_policy:DuploBatchSchedulingPolicy
cloudfront = duplo_resource.cloudfront:DuploCloudFront
configmap = duplo_resource.configmap:DuploConfigMap
cronjob = duplo_resource.cronjob:DuploCronJob
ecs = duplo_resource.ecs_service:DuploEcsService
hosts = duplo_resource.hosts:DuploHosts
infrastructure = duplo_resource.infrastructure:DuploInfrastructure
ingress = duplo_resource.ingress:DuploIngress
jit = duplo_resource.jit:DuploJit
job = duplo_resource.job:DuploJob
lambda = duplo_resource.lambda:DuploLambda
plan = duplo_resource.plan:DuploPlan
pod = duplo_resource.pod:DuploPod
pvc = duplo_resource.pvc:PersistentVolumeClaim
rds = duplo_resource.rds:DuploRDS
s3 = duplo_resource.s3:DuploS3
secret = duplo_resource.secret:DuploSecret
service = duplo_resource.service:DuploService
ssm_param = duplo_resource.ssm_param:DuploParam
storageclass = duplo_resource.storageclass:DuploStorageClass
system = duplo_resource.system:DuploSystem
tenant = duplo_resource.tenant:DuploTenant
user = duplo_resource.user:DuploUser
version = duplo_resource.version:DuploVersion

[formats.duplocloud.net]
csv = duplocloud.formats:tocsv
env = duplocloud.formats:toenv
json = duplocloud.formats:tojson
string = duplocloud.formats:tostring
yaml = duplocloud.formats:toyaml
