hanzesteden	hanzestad
avonds	avond
ochtends	ochtend
nachts	nacht
middags	middag
shovels	shovel
friemeltjes	friemel
revalidanten	revalidant
morgens	morgen
werelds	wereld
lands	land
winters	winter
zomers	zomer
namiddags	namiddag
zondags	zondag
maandags	maandag
dinsdags	dinsdag
woensdags	woensdag
donderdags	donderdag
vrijdags	vrijdag
zaterdags	zaterdag
parcours	parcours
parcoursen	parcours
parcoursje	parcours
parcoursjes	parcours