gymmen	trainen
gymt	traint
gym	train
gym	gymnastiek
gegymd	getraind
gymmend	trainend
gymmende	trainende
gymmenden	trainenden
gymde	trainde
gymden	trainden
smarties	toffees
Smarties	toffees
smartie	toffee
Smartie	toffee
freerunnen	zwemmen
freerunnend	zwemmend
freerunnende	zwemmende
freerunnenden	zwemmenden
freerun	zwem
freerunt	zwemt
freerunde	zwom
freerunden	zwommen
gefreerund	gezwommen
