wa	water	noncompletion	13
t	het	noncompletion	13862
m	hem	noncompletion	2890
pakt	gepakt	noncompletion	8
ie	hij	replacement	1624
zn	zijn	noncompletion	1602
dr	er	replacement	88
r	er	noncompletion	153
n	een	noncompletion	18386
n	en	noncompletion	6
ze	zijn	replacement	52
hebt	heeft	replacement	10
nie	niet	noncompletion	2873
wout	wilde	replacement	1
gepa	gepakt	noncompletion	1
wilt	wil	replacement	7
es	eens	noncompletion	5051
drvan	ervan	replacement	4
drop	erop	replacement	2
balleres	balletdanseres	noncompletion	2
wou	wilde	replacement	13
tie	hij	replacement	399
kijkte	keek	replacement	1
sch	schopt	noncompletion	2
pak	pakt	noncompletion	6
heb	hebt	noncompletion	64
woud	wilde	replacement	1
heb	heeft	replacement	5
klimde	klom	replacement	1
kande	kon	replacement	1
zatte	zat	replacement	1
konde	kon	replacement	1
eette	at	replacement	3
kochte	kocht	replacement	1
klomde	klom	replacement	1
dr	haar	replacement	26
drin	erin	replacement	3
pi	piraat	noncompletion	3
a	aan	noncompletion	2
	dat	noncompletion	9
geef	geeft	replacement	2
klim	klom	replacement	1
draan	eraan	replacement	10
drmee	ermee	replacement	2
hui	huilt	noncompletion	1
vissenet	visnet	replacement	1
druit	eruit	replacement	5
ij	ijsje	noncompletion	3
brandweer	brandweerman	noncompletion	1
f	fee	noncompletion	2
plukke	plukt	replacement	1
ri	ridder	noncompletion	4
geef	geeft	noncompletion	9
valte	viel	replacement	2
draf	eraf	replacement	3
pluk	plukt	noncompletion	2
er	haar	replacement	2
koopte	kocht	replacement	3
dee	deed	noncompletion	61
loopte	liep	replacement	1
roepte	riep	replacement	2
z	ze	noncompletion	143
d	dat	noncompletion	7
spr	sproeien	noncompletion	1
da	dat	noncompletion	7352
s	is	noncompletion	6530
dr	daar	noncompletion	39
woon	gewoon	noncompletion	3
daneres	danseres	noncompletion	2
op	opvissen	noncompletion	1
woude	wilde	replacement	2
doo	door	noncompletion	4
geefte	gaf	replacement	1
mo	moet	noncompletion	2
namd	nam	replacement	1
da	dan	noncompletion	20
me	mijn	replacement	83
he	heks	noncompletion	3
ijs	ijsje	noncompletion	1
cow	cowboy	noncompletion	5
neemde	nam	replacement	1
ope	opeten	noncompletion	5
wat	water	noncompletion	4
d	de	noncompletion	127
je	haar	replacement	1
haa	haar	noncompletion	6
op	opeten	noncompletion	1
dat	nadat	noncompletion	1
hard	harde	noncompletion	1
is	heeft	replacement	1
wegpakke	wegpakken	noncompletion	1
rid	ridder	noncompletion	1
hep	heeft	replacement	4
bij	blij	noncompletion	2
drietig	verdrietig	noncompletion	2
st	stopt	noncompletion	1
ne	net	noncompletion	4
ba	bal	noncompletion	5
li	likt	noncompletion	1
geef	gaf	replacement	1
deruit	eruit	replacement	4
trappe	trappen	noncompletion	3
kli	klimt	noncompletion	1
ga	gaat	noncompletion	86
o	over	noncompletion	1
i	is	noncompletion	39
vul	vult	noncompletion	1
mei	meisje	noncompletion	4
mn	mijn	noncompletion	593
wa	wat	noncompletion	966
ba	ballerina	noncompletion	2
pa	pakte	noncompletion	2
geve	geven	noncompletion	32
voetballe	voetballen	noncompletion	13
likke	likken	noncompletion	1
kijk	kijken	noncompletion	12
die	hij	replacement	226
helpde	hielp	replacement	1
balle	ballerina	noncompletion	2
em	hem	noncompletion	344
h	hij	noncompletion	3
ns	eens	noncompletion	17
sto	stond	noncompletion	1
teg	tegen	noncompletion	2
et	het	noncompletion	338
gaa	gaat	noncompletion	94
k	ik	noncompletion	3149
lijk	lijkt	noncompletion	1
ete	eten	noncompletion	195
zoek	zoekt	noncompletion	1
giet	gieter	noncompletion	2
do	door	noncompletion	1
hee	heeft	noncompletion	16
e	en	noncompletion	12
an	aan	noncompletion	2
ma	maar	noncompletion	45
opete	opeten	noncompletion	57
he	heeft	noncompletion	6
hee	heel	noncompletion	7
he	helaas	noncompletion	1
w	we	noncompletion	65
inhale	inhalen	noncompletion	1
kope	kopen	noncompletion	86
is	eens	replacement	253
gevalle	gevallen	noncompletion	14
wan	want	noncompletion	9
uitgelope	uitgelopen	noncompletion	1
lope	lopen	noncompletion	11
da	danst	noncompletion	1
str	stromen	noncompletion	1
make	maken	noncompletion	166
de	deze	noncompletion	31
wijste	wees	replacement	1
geefde	gaf	replacement	6
v	van	noncompletion	2
koo	koopt	noncompletion	1
voe	voetbal	noncompletion	1
loop	loopt	noncompletion	3
bl	bloem	noncompletion	1
n	naar	noncompletion	1
plukke	plukken	noncompletion	5
g	geeft	noncompletion	2
hande	handen	noncompletion	25
g	gaat	noncompletion	3
huile	huilen	noncompletion	38
koning	koningin	noncompletion	2
k	koningin	noncompletion	1
loo	loopt	noncompletion	1
zitte	zitten	noncompletion	120
pakke	pakken	noncompletion	115
pa	pakt	noncompletion	1
bloeme	bloemen	noncompletion	8
gekr	gekregen	noncompletion	1
gegeeft	gegeven	replacement	1
voe	voetbalt	noncompletion	1
ap	appel	noncompletion	3
maak	maakt	noncompletion	5
str	straat	noncompletion	1
w	was	noncompletion	1
pak	pakte	noncompletion	1
g	ging	noncompletion	1
v	vullen	noncompletion	1
vulle	vullen	noncompletion	2
e	er	noncompletion	4
krijge	krijgen	noncompletion	9
k	kleinste	noncompletion	1
pluk	plukte	noncompletion	1
s	steen	noncompletion	1
eind	einde	noncompletion	1
bannerina	ballerina	replacement	1
bl	bloemen	noncompletion	1
wi	wilt	noncompletion	1
he	hebt	noncompletion	2
z	zijn	noncompletion	2
ha	haar	noncompletion	1
abbel	appel	replacement	1
vij	vijf	noncompletion	4
blallerina	ballerina	replacement	1
sproei	sproeide	noncompletion	1
kwa	kwam	noncompletion	1
v	vissen	noncompletion	1
gi	ging	noncompletion	4
bloem	bloemetjes	noncompletion	1
hout	houten	noncompletion	1
vrese	vreselijk	noncompletion	1
langeke	lange	replacement	1
pel	appel	noncompletion	1
ge	geeft	noncompletion	1
koningi	koningin	noncompletion	1
scho	schot	noncompletion	1
giete	gieter	noncompletion	1
volgen	volgende	noncompletion	2
tie	die	replacement	4
vasthoude	vasthouden	noncompletion	2
balle	balletje	noncompletion	3
hebbe	hebben	noncompletion	65
heef	heeft	noncompletion	75
denk	dank	replacement	1
spele	spelen	noncompletion	89
pa	pakken	noncompletion	1
er	hem	replacement	1
ut	uit	noncompletion	1
trug	terug	noncompletion	25
kij	kijkt	noncompletion	2
balleri	ballerina	noncompletion	1
doe	doet	noncompletion	84
vu	vult	noncompletion	1
gie	gieter	noncompletion	1
tra	trapt	noncompletion	1
vi	vist	noncompletion	1
k	komt	noncompletion	1
haa	haalt	noncompletion	1
da	daar	noncompletion	19
bladzij	bladzijde	noncompletion	1
str	strooit	noncompletion	1
muntj	muntje	noncompletion	1
v	visnet	noncompletion	2
vis	visnet	noncompletion	1
gi	gieter	noncompletion	1
aan	eraan	noncompletion	1
cowbo	cowboy	noncompletion	1
vr	vraagt	noncompletion	1
prinse	prinses	noncompletion	1
bloem	bloempjes	noncompletion	1
hek	heks	noncompletion	1
zie	ziet	noncompletion	12
we	weer	noncompletion	1
me	met	noncompletion	344
ui	uit	noncompletion	4
ged	gedaan	noncompletion	1
hale	halen	noncompletion	17
ridde	ridder	noncompletion	1
vielt	valt	replacement	1
sm	smult	noncompletion	1
na	nam	noncompletion	1
plan	plantjes	noncompletion	1
ball	ballerina	noncompletion	1
hare	haren	noncompletion	13
ko	koningin	noncompletion	1
za	zag	noncompletion	2
schiette	schoot	replacement	1
houde	hield	replacement	4
kijke	kijken	noncompletion	100
dt	dat	noncompletion	1
lelij	lelijke	noncompletion	2
app	appel	noncompletion	1
hore	horen	noncompletion	2
g	geld	noncompletion	1
s	schoppen	noncompletion	1
hou	houten	noncompletion	1
bal	ballerina	noncompletion	1
pir	piraat	noncompletion	1
o	of	noncompletion	5
ij	ijscoman	noncompletion	1
schop	schopt	noncompletion	1
meegenome	meegenomen	noncompletion	3
sta	staat	noncompletion	3
zus	zuster	noncompletion	1
pro	probeert	noncompletion	1
teru	terug	noncompletion	1
zijn	haar	replacement	4
r	haar	noncompletion	26
haatjes	haartjes	noncompletion	1
hijsje	ijsje	replacement	1
r	haar	replacement	1
a	appel	noncompletion	2
bloemtjes	bloemetjes	noncompletion	1
staap	staat	replacement	1
benede	beneden	noncompletion	7
gekrege	gekregen	noncompletion	16
visse	vissen	noncompletion	7
in	erin	replacement	1
prate	praten	noncompletion	12
kuppen	plukken	explanation	1
de	deelt	noncompletion	1
stukj	stukje	noncompletion	1
tatto	auto	explanation	1
aan	haan	explanation	5
koet	koetje	explanation	1
bee	beer	explanation	8
boem	bloem	explanation	8
ge	geel	explanation	1
ood	rood	explanation	2
sies	vies	explanation	8
Shei'a	Sheila	explanation	1
koen	schoen	explanation	1
maam	haan	explanation	1
haam	haan	explanation	1
paad	paard	explanation	18
kim	klimmen	explanation	2
totoos	auto	explanation	5
desse	deksel	explanation	2
goot	groot	explanation	4
doose	doosje	explanation	1
saat	gaat	explanation	13
dzo	zo	explanation	1
anders	andere	explanation	1
saar	daar	explanation	1
saal	haal	explanation	1
saan	gaan	explanation	1
bruiken	gebruiken	explanation	4
keerd	verkeerd	explanation	2
stei	seinpaal	explanation	1
he	muts	explanation	1
veven	geven	explanation	3
choot	schoot	explanation	4
mus	muts	explanation	1
anner	andere	explanation	2
ze	zit	explanation	1
see	sneeuw	explanation	1
vallen	gevallen	explanation	6
tasje	bedje	explanation	1
begbengen	wegbrengen	explanation	2
skieuw	ski	explanation	1
ojefa	olifant	explanation	2
boe	koe	explanation	1
kokke	eend	explanation	1
oje	olifant	explanation	1
ap	appel	explanation	1
au	strijkijzer	explanation	1
kippie	schaar	explanation	1
piege	vliegtuig	explanation	1
soetoe	stoel	explanation	1
ponne	Yvonne	explanation	1
oop	open	explanation	8
zotes	grote	explanation	1
burg	berg	explanation	1
plassen	blazen	explanation	1
maat	tomaat	explanation	2
we	bewegen	explanation	4
plassijde	bladzijde	explanation	2
pas	plast	explanation	1
kein	klein	explanation	4
ooid	gegooid	explanation	2
lullie	jullie	explanation	2
ooien	gooien	explanation	2
gaat	ga	explanation	2
tee	twee	explanation	6
kuipen	kruipen	explanation	2
viesje	serviesje	explanation	2
kaar	klaar	explanation	4
Hijke	Marijke	explanation	2
rado	radio	explanation	1
ziek	muziek	explanation	3
nie	niet	explanation	2
veelbank	speelbank	explanation	1
xxx	krijg	explanation	1
da	daar	explanation	3
kik	klok	explanation	1
knorrens	varkens	explanation	1
loge	horloge	explanation	1
bain	bal	explanation	1
bai	bal	explanation	2
ba	bal	explanation	3
haan	banaan	explanation	1
baan	banaan	explanation	2
pak	pakken	explanation	8
lee	lepel	explanation	1
messs	mes	explanation	1
sapen	slapen	explanation	11
Tischa	Mischa	explanation	1
tout	stout	explanation	3
saam	samen	explanation	1
pot	kapot	explanation	26
mamama	mama	explanation	1
pis	vis	explanation	2
Pischa	Mischa	explanation	1
boet	broertje	explanation	1
pag	vlag	explanation	1
wate	water	explanation	5
daai	daar	explanation	2
taan	staan	explanation	5
e	even	explanation	1
dietuin	dierentuin	explanation	1
tein	trein	explanation	10
kimmen	klimmen	explanation	2
ma	mag	explanation	6
klei	kleine	explanation	1
dit	deze	explanation	1
pisa	pistool	explanation	1
reren	leren	explanation	1
dich	dicht	explanation	5
kool	goal	explanation	1
mee	meneer	explanation	1
boodje	broodje	explanation	1
dinken	drinken	explanation	6
roo	rode	explanation	1
anne	andere	explanation	9
stepje	schepje	explanation	1
wos	worst	explanation	2
kokool	stoffer	explanation	1
boot	vlag	explanation	1
taat	staart	explanation	1
eetje	eitje	explanation	1
sosteen	dobbelsteen	explanation	1
teen	steen	explanation	1
stostoel	paddestoel	explanation	1
hasloen	handschoen	explanation	1
pes	pet	explanation	2
hijssie	flesje	explanation	1
les	fles	explanation	1
soen	schoen	explanation	2
wek	weg	explanation	1
daa	daar	explanation	3
totos	auto	explanation	1
tata	papegaai	explanation	4
tat	papegaai	explanation	1
boeke	boekje	explanation	1
kot	kapot	explanation	2
taad	paard	explanation	1
ding	ring	explanation	2
kijn	konijn	explanation	1
deu	deur	explanation	1
siesse	vies	explanation	1
haam	raam	explanation	1
toor	toren	explanation	2
koet	koe	explanation	1
kok	klok	explanation	8
ma	mama	explanation	1
ta	ja	explanation	1
lees	lezen	explanation	1
bij	erbij	explanation	1
da	ja	explanation	1
chep	schelp	explanation	2
nee	niet	explanation	1
juiken	ruiken	explanation	1
sas	vast	explanation	2
bok	blok	explanation	1
zellig	gezellig	explanation	1
chuit	beschuit	explanation	1
mellek	melk	explanation	1
anwe	andere	explanation	1
glote	grote	explanation	2
voorstee	schoorsteen	explanation	1
dee	twee	explanation	1
be	met	explanation	1
plitie	politie	explanation	1
gaat	gat	explanation	1
moe	moet	explanation	6
tree	twee	explanation	7
zlatte	zwarte	explanation	1
Vieven	Steven	explanation	1
pitool	pistool	explanation	1
varkje	varkentje	explanation	1
wor	word	explanation	1
een	'n	explanation	1
't	wat	explanation	1
trees	twee	explanation	1
Jona	jongen	explanation	2
niet	nee	explanation	1
alma	allemaal	explanation	1
issen	vissen	explanation	1
toos	aquarium	explanation	1
konij	konijn	explanation	1
haatjes	haartjes	explanation	2
lape	slapen	explanation	6
ie	de	explanation	1
tie	die	explanation	1
taan	gaan	explanation	1
sraks	straks	explanation	1
taan	opstaan	explanation	1
annere	andere	explanation	2
pele	spelen	explanation	4
uis	huis	explanation	2
geschuld	geschud	explanation	1
totto	auto	explanation	1
moo	mooi	explanation	1
ond	hond	explanation	1
de	deze	explanation	1
bok	boksen	explanation	1
ka	klaar	explanation	1
kakakakaka	klaar	explanation	1
neu	neus	explanation	1
Bebe	Bert	explanation	2
ping	pinguin	explanation	2
Anne	Andre	explanation	1
hie	hier	explanation	14
hee	verkeerd	explanation	2
hei	hier	explanation	2
to	zo	explanation	18
bi	billen	explanation	2
po	kapot	explanation	2
kuk	stuk	explanation	2
oppe	opruimen	explanation	1
hoo	hoofd	explanation	1
tuk	stuk	explanation	11
tof	pantoffel	explanation	1
kee	keer	explanation	3
mo	motor	explanation	1
Kas	Lucas	explanation	1
ten	eten	explanation	1
Kokas	Lucas	explanation	1
Fefie	Suzanne	explanation	1
Kekkie	Gregory	explanation	1
dit	dicht	explanation	2
hukke	drukken	explanation	1
appebie	alsjeblieft	explanation	1
daaie	draaien	explanation	3
toto	foto	explanation	1
bengen	brengen	explanation	2
hijgen	hijsen	explanation	1
kijna	bijna	explanation	1
klaan	kraan	explanation	1
drekt	direct	explanation	1
agge	achter	explanation	1
tot	toch	explanation	1
ko	goal	explanation	1
poebe	voetballen	explanation	1
boerten	boertje	explanation	1
wewegen	bewegen	explanation	1
tit	zit	explanation	1
tangen	vangen	explanation	1
tee	zee	explanation	1
taat	staat	explanation	1
tan	kan	explanation	5
plakt	geplakt	explanation	1
poortrein	spoortrein	explanation	1
tagen	zagen	explanation	1
daan	gedaan	explanation	2
moch	mocht	explanation	1
aftagen	afzagen	explanation	1
nede	beneden	explanation	1
goog	oog	explanation	1
pepe	hebben	explanation	1
ten	tekenen	explanation	2
tennen	tekenen	explanation	1
bla	bloem	explanation	1
bo	bloem	explanation	1
to	auto	explanation	1
noemo	motor	explanation	1
we	weg	explanation	1
ko	op	explanation	1
tin	tekenen	explanation	1
boe	boer	explanation	4
komma	klompen	explanation	1
kom	klomp	explanation	1
komme	klompen	explanation	1
me	melk	explanation	1
bom	brommer	explanation	1
tadi	baby	explanation	1
tenne	tekenen	explanation	1
kaka	hijskraan	explanation	1
boe	melkboer	explanation	1
Anne	Anneke	explanation	1
deg	weg	explanation	1
tloon	telefoon	explanation	3
tata	gitaar	explanation	1
lummen	drummen	explanation	1
bij	voorbij	explanation	1
dedich	dicht	explanation	1
tat	patat	explanation	2
kokke	klok	explanation	1
saapt	slaapt	explanation	2
vief	lief	explanation	1
gote	grote	explanation	3
deutje	deurtje	explanation	2
afgewoke	afgebroken	explanation	1
annetje	mannetje	explanation	1
af	eraf	explanation	1
toot	boot	explanation	1
soeie	roeien	explanation	1
el	wel	explanation	1
i	is	explanation	2
ashoue	vasthouden	explanation	1
oene	schoenen	explanation	1
solle	rollen	explanation	1
jeuk	leuk	explanation	1
jijden	rijden	explanation	1
etootjes	cadeautjes	explanation	1
tetegen	gekregen	explanation	1
Tinterjaas	Sinterklaas	explanation	1
Zatte	zwarte	explanation	1
jag	mag	explanation	1
sijbaan	glijbaan	explanation	1
heppe	scheppen	explanation	1
opheppe	opscheppen	explanation	1
sashouden	vasthouden	explanation	1
jaat	gaat	explanation	1
jater	water	explanation	2
tien	klein	explanation	1
tadje	badje	explanation	1
jaan	gaan	explanation	1
jensen	mensen	explanation	1
tiet	niet	explanation	6
sing	ging	explanation	1
sijen	glijden	explanation	2
sa	ga	explanation	2
tan	dan	explanation	2
loet	moet	explanation	1
soorlezen	voorlezen	explanation	1
juis	muis	explanation	4
jaar	raar	explanation	1
telen	spelen	explanation	2
zeedad	zebra	explanation	1
zedra	zebra	explanation	1
soenes	groene	explanation	1
jel	wel	explanation	1
toen	groen	explanation	1
jekker	lekker	explanation	1
jeet	weet	explanation	1
jete	weten	explanation	1
los	bos	explanation	1
tlee	twee	explanation	2
tant	kant	explanation	2
it	top	explanation	1
it	truck	explanation	1
it's	truck	explanation	1
that	stool	explanation	1
that	object	explanation	10
it	object	explanation	13
des	does	noncompletion	4
here	box	explanation	11
that	crayon	explanation	3
that's	crayon	explanation	2
it	crayon	explanation	11
aby	baby	noncompletion	1
this	bag	explanation	2
this	picture	explanation	8
it	bag	explanation	1
it	box	explanation	14
them	crayons	explanation	5
those	crayons	explanation	8
that	box	explanation	1
this	object	explanation	2
it	door	explanation	1
he	clown	explanation	1
him	clown	explanation	8
it'll	object	explanation	2
itself	object	explanation	1
one	box	explanation	6
there	box	explanation	6
that's	box	explanation	1
0	box	explanation	1
that	paper	explanation	1
pink	crayon	explanation	1
it	draw	explanation	4
one	crayon	explanation	23
ours	crayons	explanation	1
they	crayons	explanation	1
red	crayon	explanation	1
blue	crayon	explanation	1
0	crayon	explanation	1
green	crayon	explanation	1
these	crayon	explanation	1
it	camera	explanation	1
it'll	clown	explanation	1
it	paper	explanation	4
this	crayon	explanation	4
fa	face	noncompletion	1
it's	box	explanation	3
kay	okay	noncompletion	11
this	box	explanation	4
	ter	noncompletion	1
two	crayons	explanation	1
thing	garage	explanation	1
[?]	garage	explanation	1
that's	picture	explanation	8
that	picture	explanation	18
banket	blanket	noncompletion	1
sweaer	sweater	noncompletion	1
sanich	sandwich	noncompletion	1
buerfly	butterfly	noncompletion	1
it	story	explanation	1
ye	yes	noncompletion	1
it's	crayon	explanation	2
re	red	noncompletion	1
that	room	explanation	1
that's	room	explanation	1
there	room	explanation	4
it	room	explanation	1
seep	sleep	noncompletion	1
that	clown	explanation	1
it's	object	explanation	3
e	he	noncompletion	377
that	draw	explanation	1
these	crayons	explanation	1
it	picture	explanation	1
	are	noncompletion	1
yeah	yes	explanation	2
it	clown	explanation	4
it'll	box	explanation	2
gaat	heeft	explanation	1
onder	in	explanation	1
gaat	doet	explanation	2
op	voor	explanation	1
op	om	explanation	1
is	heeft	explanation	3
op	aan	explanation	1
onder	op	explanation	2
op	naar	explanation	1
af	weg	explanation	1
vallen	gevallen	noncompletion	25
klimt	geklommen	explanation	1
vrouwtje	mevrouwtje	noncompletion	1
lellu	brandweer	explanation	2
loekie	varken	explanation	1
loekietjes	varkentjes	explanation	1
lellu	brandweerauto	explanation	1
vrouw	mevrouw	noncompletion	15
ope	open	noncompletion	120
ee	hee	noncompletion	9
as	als	noncompletion	192
iep	piep	noncompletion	1
emaal	helemaal	noncompletion	6
oor	hoor	noncompletion	23
plakke	plakken	noncompletion	9
g	ge	noncompletion	112
ebt	hebt	noncompletion	101
oe	hoe	noncompletion	65
goe	goed	noncompletion	187
eb	heb	noncompletion	270
silicone	siliconen	noncompletion	1
gewonne	gewonnen	noncompletion	8
spuwe	spuwen	noncompletion	1
vertelle	vertellen	noncompletion	25
zwemme	zwemmen	noncompletion	41
pirate	piraten	noncompletion	1
tege	tegen	noncompletion	34
bene	benen	noncompletion	10
tusse	tussen	noncompletion	16
	ge	noncompletion	9
ebbe	hebben	noncompletion	165
ato	auto	noncompletion	1
ier	hier	noncompletion	268
stat	start	noncompletion	1
geft	geeft	noncompletion	2
wate	water	noncompletion	20
brenge	brengen	noncompletion	10
snottebelle	snottebellen	noncompletion	6
op	hop	noncompletion	2
tzelfde	hetzelfde	noncompletion	23
elpt	helpt	noncompletion	2
glijde	glijden	noncompletion	2
laasje	glaasje	noncompletion	1
omda	omdat	noncompletion	27
zeewate	zeewater	noncompletion	1
worde	worden	noncompletion	15
	het	noncompletion	14
ela	hela	noncompletion	11
ij	hij	noncompletion	34
springe	springen	noncompletion	15
slape	slapen	noncompletion	58
ele	hele	noncompletion	14
oog	hoog	noncompletion	8
ik	kik	noncompletion	4
spinge	springen	noncompletion	3
klimme	klimmen	noncompletion	2
trekke	trekken	noncompletion	5
moch	mocht	noncompletion	8
gote	grote	noncompletion	11
stan	staan	noncompletion	2
vin	vind	noncompletion	411
neme	nemen	noncompletion	16
ligge	liggen	noncompletion	63
elemaal	helemaal	noncompletion	27
an	dan	noncompletion	3
ange	hangen	noncompletion	3
gemeenteuis	gemeentehuis	noncompletion	1
ma	mag	noncompletion	68
werke	werken	noncompletion	8
imme	immer	noncompletion	1
moete	moeten	noncompletion	64
an	andere	noncompletion	4
lijne	lijnen	noncompletion	3
moe	moet	noncompletion	345
same	samen	noncompletion	16
strate	straten	noncompletion	1
ebben	hebben	noncompletion	23
mijde	mijden	noncompletion	2
rije	rijden	noncompletion	20
buite	buiten	noncompletion	51
ale	halen	noncompletion	21
kome	komen	noncompletion	31
	hier	noncompletion	4
toe	toen	noncompletion	2
stoppe	stoppen	noncompletion	9
snije	snijden	noncompletion	8
kerse	kersen	noncompletion	1
e	ene	noncompletion	1
beje	bedje	noncompletion	4
maa	maar	noncompletion	314
draaie	draaien	noncompletion	16
ierin	hierin	noncompletion	2
naa	naar	noncompletion	45
daa	daar	noncompletion	326
vergete	vergeten	noncompletion	12
lins	links	noncompletion	2
rechs	rechts	noncompletion	1
duwe	duwen	noncompletion	5
kuipe	kruipen	noncompletion	2
eel	heel	noncompletion	86
ard	hard	noncompletion	15
vandale	vandalen	noncompletion	2
ees	eens	noncompletion	27
ad	had	noncompletion	31
tekene	tekenen	noncompletion	7
eeft	heeft	noncompletion	134
geete	gegeten	noncompletion	1
gebouwe	gebouwen	noncompletion	1
mouwe	mouwen	noncompletion	5
gespronge	gesprongen	noncompletion	1
nik	niks	noncompletion	1
zeg	zeggen	noncompletion	1
bove	boven	noncompletion	37
zegge	zeggen	noncompletion	53
ebb	hebben	noncompletion	3
goord	gehoord	noncompletion	10
e	eh	noncompletion	583
staa	staat	noncompletion	18
ond	hond	noncompletion	13
koeie	koeien	noncompletion	4
vrachwage	vrachtwagen	noncompletion	1
uis	huis	noncompletion	10
bome	bomen	noncompletion	10
amaal	allemaal	noncompletion	13
vrachtwage	vrachtwagen	noncompletion	3
men	meneer	noncompletion	1
valle	vallen	noncompletion	47
aa	daar	noncompletion	1
benge	brengen	noncompletion	1
inpakke	inpakken	noncompletion	6
vachwage	vrachtwagen	noncompletion	1
eitje	eitjes	noncompletion	1
allemaa	allemaal	noncompletion	10
a	ah	noncompletion	96
wone	wonen	noncompletion	2
kleure	kleuren	noncompletion	17
veraaltje	verhaaltje	noncompletion	5
wolke	wolken	noncompletion	9
kikke	kikker	noncompletion	29
varke	varken	noncompletion	8
eet	heet	noncompletion	8
stene	stenen	noncompletion	3
was	wast	noncompletion	1
flesse	flessen	noncompletion	2
verhaalje	verhaaltje	noncompletion	1
ie	hier	noncompletion	11
vliege	vliegen	noncompletion	13
ho	hoger	noncompletion	1
winne	winnen	noncompletion	9
oorde	hoorde	noncompletion	3
daarbuite	daarbuiten	noncompletion	1
uisje	huisje	noncompletion	5
drinke	drinken	noncompletion	42
dinke	drinken	noncompletion	17
ove	oven	noncompletion	1
vare	varen	noncompletion	4
tezame	tezamen	noncompletion	1
zwem	zwemmen	noncompletion	1
platemaakt	platgemaakt	noncompletion	1
toffe	koffie	replacement	1
ee	heeft	noncompletion	5
Dietr	Dieter	noncompletion	1
wachte	wachten	noncompletion	12
schildere	schilderen	noncompletion	1
proeve	proeven	noncompletion	11
ee	een	noncompletion	198
ama	mama	noncompletion	1
late	laten	noncompletion	31
ande	handen	noncompletion	8
gespele	gespelen	noncompletion	1
dinge	dingen	noncompletion	6
i	ik	noncompletion	24
gespeel	gespeeld	noncompletion	1
wee	weer	noncompletion	25
tijd	altijd	noncompletion	1
altij	altijd	noncompletion	13
jonge	jongen	noncompletion	21
wee	weet	noncompletion	19
oge	ogen	noncompletion	23
tael	tafel	noncompletion	1
snijde	snijden	noncompletion	1
nijde	snijden	noncompletion	1
morge	morgen	noncompletion	16
no	nog	noncompletion	57
oort	hoort	noncompletion	7
wiele	wielen	noncompletion	3
patte	platte	noncompletion	1
ijskas	ijskast	noncompletion	3
dingend	dringend	noncompletion	1
e	heb	noncompletion	2
iet	iets	noncompletion	58
kunne	kunnen	noncompletion	40
mui	muis	noncompletion	1
gevone	gevonden	noncompletion	1
steke	steken	noncompletion	14
wense	wensen	noncompletion	1
prcies	precies	noncompletion	1
ziekewage	ziekenwagen	noncompletion	1
ziekenuis	ziekenhuis	noncompletion	2
ore	oren	noncompletion	10
s	eens	noncompletion	18
u	uw	noncompletion	79
voete	voeten	noncompletion	9
laarze	laarzen	noncompletion	1
zweetvoete	zweetvoeten	noncompletion	1
allo	hallo	noncompletion	5
Diete	Dieter	noncompletion	3
rijen	rijden	noncompletion	44
waaom	waarom	noncompletion	3
ore	horen	noncompletion	4
spreke	spreken	noncompletion	5
ware	waren	noncompletion	18
eef	heeft	noncompletion	6
avons	avonds	noncompletion	2
o	open	noncompletion	4
tui	trui	noncompletion	19
kom	komt	noncompletion	22
dekke	dekken	noncompletion	2
bod	bord	noncompletion	10
kaa	kaas	noncompletion	8
vin	vindt	noncompletion	6
stink	stinkt	noncompletion	1
worsje	worstje	noncompletion	1
boteram	boterham	noncompletion	5
jo	joh	noncompletion	1
ale	alen	noncompletion	1
j	je	noncompletion	18
ee	heet	noncompletion	1
ee	eet	noncompletion	1
krijg	krijgt	noncompletion	2
e	ge	noncompletion	69
chocola	chocolade	noncompletion	4
blijve	blijven	noncompletion	19
nerges	nergens	noncompletion	3
aankome	aankomen	noncompletion	4
andjes	handjes	noncompletion	4
ba	bah	noncompletion	4
bt	hebt	noncompletion	3
wete	weten	noncompletion	10
ondjes	hondjes	noncompletion	1
ondje	hondje	noncompletion	9
zouen	zouden	noncompletion	4
kruipe	kruipen	noncompletion	7
prente	prenten	noncompletion	1
ieronder	hieronder	noncompletion	2
voor	voort	noncompletion	1
raa	raar	noncompletion	1
	hoe	noncompletion	3
we	wel	noncompletion	15
oekje	hoekje	noncompletion	2
zenuwe	zenuwen	noncompletion	1
fran	frank	noncompletion	4
spuite	spuiten	noncompletion	2
ure	uren	noncompletion	2
verandere	veranderen	noncompletion	2
weke	werken	noncompletion	1
nadenke	nadenken	noncompletion	2
moelijk	moeilijk	noncompletion	2
he	het	noncompletion	7
lange	langer	noncompletion	1
ver	verder	noncompletion	5
opvulle	opvullen	noncompletion	1
ondertusse	ondertussen	noncompletion	2
opange	ophangen	noncompletion	2
probleme	problemen	noncompletion	1
afgesnee	afgesneden	noncompletion	1
achte	achten	noncompletion	1
helpe	helpen	noncompletion	29
ode	orde	noncompletion	1
doo	doos	noncompletion	2
elpe	helpen	noncompletion	7
wasse	wassen	noncompletion	42
intrekke	intrekken	noncompletion	2
ze	zeg	noncompletion	18
gewasse	gewassen	noncompletion	5
an	anders	noncompletion	1
mij	mijn	noncompletion	78
aanklede	aankleden	noncompletion	1
a	als	noncompletion	48
mnen	mijnen	noncompletion	1
oop	hoop	noncompletion	4
dure	duren	noncompletion	1
aar	haar	noncompletion	42
gekoze	gekozen	noncompletion	1
zulle	zullen	noncompletion	9
morg	morgen	noncompletion	4
doeke	doeken	noncompletion	2
aanouden	aanhouden	noncompletion	1
chien	Annechien	noncompletion	2
aanoue	aanhouden	noncompletion	2
aanoudt	aanhoudt	noncompletion	1
kieze	kiezen	noncompletion	10
oudt	houdt	noncompletion	2
dez	deze	noncompletion	122
oen	doen	noncompletion	5
g	gij	noncompletion	8
et	hebt	noncompletion	16
onderem	onderhemd	noncompletion	1
oeveel	hoeveel	noncompletion	36
gistere	gisteren	noncompletion	13
oze	onze	noncompletion	1
zeve	zeven	noncompletion	16
nege	negen	noncompletion	21
wild	wilde	noncompletion	2
omoog	omhoog	noncompletion	8
houde	houden	noncompletion	3
uitoen	uitdoen	noncompletion	1
se	seffens	noncompletion	1
vanmorge	vanmorgen	noncompletion	2
geneze	genezen	noncompletion	4
ontoudt	onthoudt	noncompletion	1
tuurlijk	natuurlijk	noncompletion	42
s	des	noncompletion	2
morges	morgens	noncompletion	2
bo	boterham	noncompletion	2
va	van	noncompletion	7
pecies	precies	noncompletion	2
lippestift	lippenstift	noncompletion	5
opvouwe	opvouwen	noncompletion	2
boveste	bovenste	noncompletion	1
binne	binnen	noncompletion	26
eigelijk	eigenlijk	noncompletion	19
oge	hoge	noncompletion	5
nnechien	Annechien	noncompletion	1
bbe	hebben	noncompletion	3
knope	knopen	noncompletion	3
aartjes	haartjes	noncompletion	4
kou	koud	noncompletion	5
oofd	hoofd	noncompletion	2
Annchien	Annechien	noncompletion	2
gee	geen	noncompletion	14
krij	krijg	noncompletion	7
aan	gaan	noncompletion	2
vinde	vinden	noncompletion	4
gelede	geleden	noncompletion	3
dage	dagen	noncompletion	3
neem	neemt	noncompletion	1
denke	denken	noncompletion	5
volges	volgens	noncompletion	1
oofdje	hoofdje	noncompletion	4
ma	mama	noncompletion	5
messe	messen	noncompletion	4
moge	mogen	noncompletion	25
gelope	gelopen	noncompletion	1
eet	heeft	noncompletion	10
zette	zetten	noncompletion	33
wil	wilt	noncompletion	8
zeg	zegt	noncompletion	5
juis	juist	noncompletion	1
maw	miauw	noncompletion	1
o	ons	noncompletion	1
aemaal	allemaal	noncompletion	1
astublieft	alstublieft	noncompletion	3
evetjes	eventjes	noncompletion	2
kindere	kinderen	noncompletion	8
voorda	voordat	noncompletion	2
kere	keren	noncompletion	6
n	nee	noncompletion	3
foefele	foefelen	noncompletion	2
adde	hadden	noncompletion	7
meebrenge	meebrengen	noncompletion	2
zi	zit	noncompletion	4
lijk	gelijk	noncompletion	3
ronke	ronken	noncompletion	1
et	eet	noncompletion	1
roepe	roepen	noncompletion	5
vamiddag	vanmiddag	noncompletion	1
ft	heeft	noncompletion	46
alen	halen	noncompletion	2
morse	morsen	noncompletion	2
gete	gegeten	noncompletion	16
zet	zegt	noncompletion	1
gezonge	gezongen	noncompletion	3
zinge	zingen	noncompletion	11
wandele	wandelen	noncompletion	3
leve	leven	noncompletion	10
oera	hoera	noncompletion	22
elen	helen	noncompletion	5
arde	harde	noncompletion	1
Annechie	Annechien	noncompletion	1
kenne	kennen	noncompletion	2
klappe	klappen	noncompletion	2
balle	ballen	noncompletion	5
aanange	aanhangen	noncompletion	1
knoeie	knoeien	noncompletion	3
vamorge	vanmorgen	noncompletion	1
kuise	kuisen	noncompletion	2
lere	leren	noncompletion	12
zoeke	zoeken	noncompletion	28
zorge	zorgen	noncompletion	2
avon	avond	noncompletion	1
os	ons	noncompletion	7
un	hun	noncompletion	4
klei	klein	noncompletion	3
hange	hangen	noncompletion	2
manne	mannen	noncompletion	5
veiligeidsspelde	veiligheidsspelden	noncompletion	2
veiligeidsspeld	veiligheidsspeld	noncompletion	2
trek	trekt	noncompletion	2
deke	deken	noncompletion	3
veiligeidsspel	veiligheidsspeld	noncompletion	1
benee	beneden	noncompletion	1
gegeve	gegeven	noncompletion	9
ghad	gehad	noncompletion	2
katje	katjes	noncompletion	1
lappe	lappen	noncompletion	1
tomate	tomaten	noncompletion	6
tomaa	tomaat	noncompletion	1
druive	druiven	noncompletion	6
afgeve	afgeven	noncompletion	2
zoue	zouden	noncompletion	1
opzette	opzetten	noncompletion	4
onderd	honderd	noncompletion	3
zeie	zeiden	noncompletion	1
gooie	gooien	noncompletion	10
gesnede	gesneden	noncompletion	3
dachte	dachten	noncompletion	1
bijgehoue	bijgehouden	noncompletion	1
schelpe	schelpen	noncompletion	4
Anne	Annechien	noncompletion	1
vastpakke	vastpakken	noncompletion	1
legge	leggen	noncompletion	25
i	ieder	noncompletion	1
angt	hangt	noncompletion	8
vanbove	vanboven	noncompletion	2
eveveel	evenveel	noncompletion	2
vrage	vragen	noncompletion	14
astublief	alstublieft	noncompletion	5
verkope	verkopen	noncompletion	2
plat	platte	noncompletion	1
and	hand	noncompletion	12
voele	voelen	noncompletion	2
plekke	plekken	noncompletion	1
ang	hangt	noncompletion	1
oo	oho	noncompletion	1
vanbinne	vanbinnen	noncompletion	2
voo	voor	noncompletion	20
e	de	noncompletion	29
beginne	beginnen	noncompletion	9
gerake	geraken	noncompletion	2
kas	kast	noncompletion	49
gegete	gegeten	noncompletion	5
de	der	noncompletion	1
vine	vinden	noncompletion	1
vonde	vonden	noncompletion	3
mam	mama	noncompletion	18
meeneme	meenemen	noncompletion	10
gad	gade	noncompletion	1
el	helemaal	noncompletion	1
goee	goede	noncompletion	1
eve	even	noncompletion	148
weggeve	weggeven	noncompletion	1
toppe	toppen	noncompletion	3
opneme	opnemen	noncompletion	4
geleze	gelezen	noncompletion	2
oedje	hoedje	noncompletion	1
ontoude	onthouden	noncompletion	1
snuite	snuiten	noncompletion	2
leze	lezen	noncompletion	21
dobbelstene	dobbelstenen	noncompletion	2
stonde	stonden	noncompletion	2
macheert	marcheert	noncompletion	1
a	dat	noncompletion	17
luistere	luisteren	noncompletion	5
lippe	lippen	noncompletion	1
program	programma	noncompletion	1
elpen	helpen	noncompletion	3
ij	gij	noncompletion	1
maa	maat	noncompletion	1
aa	aan	noncompletion	4
telle	tellen	noncompletion	15
ardop	hardop	noncompletion	1
zevetien	zeventien	noncompletion	4
negtien	negentien	noncompletion	2
kaarte	kaarten	noncompletion	16
strijke	strijken	noncompletion	2
schrijve	schrijven	noncompletion	3
ou	hou	noncompletion	2
teruggekrege	teruggekregen	noncompletion	1
oek	hoek	noncompletion	1
probere	proberen	noncompletion	6
effe	heffen	noncompletion	1
knippe	knippen	noncompletion	13
d	dan	noncompletion	1
vege	vegen	noncompletion	2
ie	iet	noncompletion	3
	te	noncompletion	3
wene	wenen	noncompletion	4
droge	drogen	noncompletion	4
doe	doen	noncompletion	4
beugele	beugelen	noncompletion	2
stukke	stukken	noncompletion	10
teke	tekenen	noncompletion	41
ierbij	hierbij	noncompletion	1
roz	roze	noncompletion	7
arme	armen	noncompletion	3
schrikke	schrikken	noncompletion	1
zoas	zoals	noncompletion	5
dezn	dezen	noncompletion	1
bovearm	bovenarm	noncompletion	1
zoude	zouden	noncompletion	1
moeste	moesten	noncompletion	3
p	op	noncompletion	8
zij	zijn	noncompletion	5
eette	heette	noncompletion	1
lus	lust	noncompletion	20
strak	straks	noncompletion	5
gaa	gaan	noncompletion	8
tomatesaus	tomatensaus	noncompletion	2
sportschoene	sportschoenen	noncompletion	1
korsjes	korstjes	noncompletion	3
erges	ergens	noncompletion	6
t	te	noncompletion	33
pap	papa	noncompletion	6
moes	moest	noncompletion	18
piek	piekt	noncompletion	1
polle	pollen	noncompletion	2
afblijve	afblijven	noncompletion	4
bijte	bijten	noncompletion	6
zate	zaten	noncompletion	3
keuke	keuken	noncompletion	8
luste	lusten	noncompletion	4
smaakte	smaakten	noncompletion	1
plasticin	plasticine	noncompletion	1
anden	handen	noncompletion	2
beuzele	beuzelen	noncompletion	1
die	drie	noncompletion	4
afkuise	afkuisen	noncompletion	1
meespele	meespelen	noncompletion	1
alf	half	noncompletion	4
afgewasse	afgewassen	noncompletion	1
chocolad	chocolade	noncompletion	1
zo	zon	noncompletion	1
afwasse	afwassen	noncompletion	26
ruime	ruimen	noncompletion	5
opruime	opruimen	noncompletion	5
elpers	helpers	noncompletion	1
wille	willen	noncompletion	7
eilijk	eigenlijk	noncompletion	2
inzitte	inzitten	noncompletion	5
snuffele	snuffelen	noncompletion	1
ruite	ruiten	noncompletion	2
et	heeft	noncompletion	1
lit	ligt	noncompletion	1
afruime	afruimen	noncompletion	1
ierover	hierover	noncompletion	1
dele	delen	noncompletion	1
oeft	hoeft	noncompletion	1
oopje	hoopje	noncompletion	1
spoele	spoelen	noncompletion	2
oger	hoger	noncompletion	2
etgeen	hetgeen	noncompletion	1
zowa	zowat	noncompletion	1
gebruike	gebruiken	noncompletion	4
gekome	gekomen	noncompletion	4
keur	kleur	noncompletion	1
pikke	pikken	noncompletion	2
genome	genomen	noncompletion	3
verkoude	verkouden	noncompletion	1
poppe	poppen	noncompletion	6
kouse	kousen	noncompletion	3
rondlope	rondlopen	noncompletion	2
wasandje	washandje	noncompletion	1
a	ga	noncompletion	1
eiere	eieren	noncompletion	3
potte	potten	noncompletion	3
doze	dozen	noncompletion	4
wage	wagen	noncompletion	4
bakke	bakken	noncompletion	3
omvalle	omvallen	noncompletion	2
omgevalle	omgevallen	noncompletion	2
omgevalln	omgevallen	noncompletion	1
uitgevalle	uitgevallen	noncompletion	1
roeie	roeien	noncompletion	1
f	heeft	noncompletion	2
cente	centen	noncompletion	6
ierachter	hierachter	noncompletion	1
vechte	vechten	noncompletion	3
heet	heeft	noncompletion	6
zeehonde	zeehonden	noncompletion	1
gevonde	gevonden	noncompletion	5
geworde	geworden	noncompletion	3
paasaas	paashaas	noncompletion	2
rape	rapen	noncompletion	1
gedronke	gedronken	noncompletion	4
etzelfde	hetzelfde	noncompletion	1
koeke	koeken	noncompletion	36
onger	honger	noncompletion	3
aarbei	aardbei	noncompletion	1
het	hebt	noncompletion	3
ola	hola	noncompletion	1
zuige	zuigen	noncompletion	1
s	dus	noncompletion	1
plastieke	plastieken	noncompletion	5
aar	daar	noncompletion	1
ie	die	noncompletion	5
koste	kosten	noncompletion	2
verrade	verraden	noncompletion	2
r	der	noncompletion	1
teruglegge	terugleggen	noncompletion	1
restauran	restaurant	noncompletion	1
at	dat	noncompletion	4
to	toch	noncompletion	3
ierna	hierna	noncompletion	1
piepe	piepen	noncompletion	3
jonges	jongens	noncompletion	1
meeelpe	meehelpen	noncompletion	2
nieman	niemand	noncompletion	2
ma	mak	noncompletion	5
voorstelle	voorstellen	noncompletion	2
lette	letten	noncompletion	1
b	heb	noncompletion	11
kartonne	kartonnen	noncompletion	3
martkraam	marktkraam	noncompletion	2
amburgers	hamburgers	noncompletion	1
ertusse	ertussen	noncompletion	1
vr	voor	noncompletion	1
betale	betalen	noncompletion	4
wege	wegen	noncompletion	1
toedoe	toedoet	noncompletion	1
banane	bananen	noncompletion	10
Elin	Eline	noncompletion	2
appele	appelen	noncompletion	4
asjeblief	alsjeblieft	noncompletion	1
aardappele	aardappelen	noncompletion	6
terugbrenge	terugbrengen	noncompletion	1
sees	seffens	noncompletion	2
oude	houden	noncompletion	1
oue	houden	noncompletion	1
buitekant	buitenkant	noncompletion	1
snoepe	snoepen	noncompletion	1
noeme	noemen	noncompletion	1
kiez	kiezen	noncompletion	1
sinaasappele	sinaasappelen	noncompletion	5
sappele	sappelen	noncompletion	1
inwerke	inwerken	noncompletion	1
gad	gehad	noncompletion	3
houe	houden	noncompletion	4
ruim	ruimt	noncompletion	1
tanpasta	tandpasta	noncompletion	1
papiere	papieren	noncompletion	1
rekemachientje	rekenmachientje	noncompletion	1
inlae	inladen	noncompletion	1
mart	markt	noncompletion	6
almaal	allemaal	noncompletion	11
seffes	seffens	noncompletion	6
minute	minuten	noncompletion	3
grote	groten	noncompletion	4
hel	hele	noncompletion	1
complexe	complexen	noncompletion	1
geze	gezegd	noncompletion	1
bestaa	bestaat	noncompletion	1
blondere	blonderen	noncompletion	1
daarbove	daarboven	noncompletion	2
eest	eerst	noncompletion	3
bewege	bewegen	noncompletion	1
wor	wort	noncompletion	1
zijkante	zijkanten	noncompletion	1
afale	afhalen	noncompletion	1
hemme	hemmen	noncompletion	1
het	heeft	noncompletion	1
gebore	geboren	noncompletion	10
voebal	voetbal	noncompletion	3
nen	enen	noncompletion	2
	een	noncompletion	4
e	je	noncompletion	9
knikkere	knikkeren	noncompletion	1
teruggele	teruggelegd	noncompletion	1
ben	bent	noncompletion	57
eb	hebt	noncompletion	2
rozijne	rozijnen	noncompletion	1
wor	word	noncompletion	11
geslage	geslagen	noncompletion	1
a	ha	noncompletion	1
liege	liegen	noncompletion	3
geloge	gelogen	noncompletion	1
een	eens	noncompletion	1
roere	roeren	noncompletion	3
afspoele	afspoelen	noncompletion	4
kappe	kappen	noncompletion	3
opvange	opvangen	noncompletion	1
bijhoue	bijhouden	noncompletion	1
verzette	verzetten	noncompletion	1
elmaal	helemaal	noncompletion	3
brande	branden	noncompletion	3
afdroge	afdrogen	noncompletion	3
kou	koude	noncompletion	1
gelee	geleden	noncompletion	1
eiglijk	eigenlijk	noncompletion	1
oorbelle	oorbellen	noncompletion	1
gewees	geweest	noncompletion	3
straathonde	straathonden	noncompletion	1
punte	punten	noncompletion	1
stappe	stappen	noncompletion	7
emme	hemmen	noncompletion	4
rusig	rustig	noncompletion	1
goude	gouden	noncompletion	1
rolle	rollen	noncompletion	2
blaze	blazen	noncompletion	4
schilpad	schildpad	noncompletion	15
schilpadde	schildpadden	noncompletion	4
pote	poten	noncompletion	5
schilpadden	schildpadden	noncompletion	3
totda	totdat	noncompletion	1
surfe	surfen	noncompletion	2
gevaalijk	gevaarlijk	noncompletion	4
breke	breken	noncompletion	1
gebroke	gebroken	noncompletion	1
verprutse	verprutsen	noncompletion	1
prutse	prutsen	noncompletion	1
meehelpe	meehelpen	noncompletion	11
bolle	bollen	noncompletion	3
kanne	kannen	noncompletion	1
plante	planten	noncompletion	1
wore	worden	noncompletion	2
geslote	gesloten	noncompletion	2
belle	bellen	noncompletion	3
omat	omdat	noncompletion	1
hie	hier	noncompletion	67
eige	eigen	noncompletion	8
gevonen	gevonden	noncompletion	1
leugebeest	leugenbeest	noncompletion	1
pombak	pompbak	noncompletion	1
ijzere	ijzeren	noncompletion	2
kletse	kletsen	noncompletion	2
gevaalijker	gevaarlijker	noncompletion	1
ouw	jouw	noncompletion	1
daadjes	draadjes	noncompletion	1
koon	kroon	noncompletion	1
vogetje	vogeltje	noncompletion	2
schilderije	schilderijen	noncompletion	1
uitkome	uitkomen	noncompletion	2
diere	dieren	noncompletion	2
paarde	paarden	noncompletion	1
mense	mensen	noncompletion	3
mee	meer	noncompletion	20
afvalle	afvallen	noncompletion	1
e	ze	noncompletion	1
allmaal	allemaal	noncompletion	3
emmes	emmers	noncompletion	1
houte	houten	noncompletion	1
gekeke	gekeken	noncompletion	2
opdrinke	opdrinken	noncompletion	3
ullie	jullie	noncompletion	1
to	tot	noncompletion	1
gevange	gevangen	noncompletion	3
toegemaak	toegemaakt	noncompletion	1
ginge	gingen	noncompletion	13
lache	lachen	noncompletion	14
rin	erin	noncompletion	5
stilzitte	stilzitten	noncompletion	1
tande	tanden	noncompletion	1
poetse	poetsen	noncompletion	6
geslape	geslapen	noncompletion	3
ge	geen	noncompletion	1
zijd	zijde	noncompletion	2
tgeen	hetgeen	noncompletion	6
Janne	Jannen	noncompletion	2
volwasse	volwassen	noncompletion	2
vanwaa	vanwaar	noncompletion	1
mate	maten	noncompletion	1
afzette	afzetten	noncompletion	1
babbele	babbelen	noncompletion	2
woorde	woorden	noncompletion	2
trommelstokke	trommelstokken	noncompletion	2
kloppe	kloppen	noncompletion	3
trouwes	trouwens	noncompletion	1
duike	duiken	noncompletion	17
blusse	blussen	noncompletion	1
oefene	oefenen	noncompletion	2
nee	neen	noncompletion	1
inktvisse	inktvissen	noncompletion	1
na	naar	noncompletion	3
vliegvel	vliegveld	noncompletion	1
combinere	combineren	noncompletion	1
wapestok	wapenstok	noncompletion	2
bomme	bommen	noncompletion	1
onploft	ontploft	noncompletion	2
zijne	zijnen	noncompletion	1
kund	kunde	noncompletion	5
mus	muts	noncompletion	1
i	in	noncompletion	9
ope	hopen	noncompletion	1
open	hopen	noncompletion	1
hope	hopen	noncompletion	3
wapes	wapens	noncompletion	1
nieuw	nieuws	noncompletion	1
elm	helm	noncompletion	2
andgranaat	handgranaat	noncompletion	2
onploffe	ontploffen	noncompletion	1
mee	meestal	noncompletion	1
boeve	boeven	noncompletion	1
soldate	soldaten	noncompletion	2
koor	koord	noncompletion	1
just	juist	noncompletion	2
verstaa	verstaat	noncompletion	1
ewtjes	erwtjes	noncompletion	1
ga	gade	noncompletion	1
raap	raapt	noncompletion	1
lukke	lukken	noncompletion	1
aarig	aardig	noncompletion	1
casset	cassette	noncompletion	1
	je	noncompletion	13
	t	noncompletion	2
klaarmake	klaarmaken	noncompletion	1
teminste	tenminste	noncompletion	1
	n	noncompletion	4
kakkerlakke	kakkerlakken	noncompletion	3
kwame	kwamen	noncompletion	3
lakke	lakken	noncompletion	3
liepe	liepen	noncompletion	1
elleboge	ellebogen	noncompletion	2
verschiete	verschieten	noncompletion	2
strele	strelen	noncompletion	1
tene	tenen	noncompletion	6
al	als	noncompletion	5
kusse	kussen	noncompletion	25
wegtrekke	wegtrekken	noncompletion	1
meppe	meppen	noncompletion	1
orloge	horloge	noncompletion	1
paardes	paardjes	noncompletion	1
vi	vis	noncompletion	1
ondere	onderen	noncompletion	1
afleide	afleiden	noncompletion	5
verleide	verleiden	noncompletion	2
k	kik	noncompletion	1
uitlegge	uitleggen	noncompletion	1
uiswerk	huiswerk	noncompletion	6
gedachte	gedachten	noncompletion	1
zing	zingt	noncompletion	4
wo	wow	noncompletion	1
emel	hemel	noncompletion	2
volge	volgen	noncompletion	1
had	hard	noncompletion	2
zeure	zeuren	noncompletion	2
geten	gegeten	noncompletion	15
uitsteke	uitsteken	noncompletion	1
tekefilm	tekenfilm	noncompletion	1
begonne	begonnen	noncompletion	1
bone	bonen	noncompletion	3
bodje	bordje	noncompletion	1
krij	krijgt	noncompletion	1
boere	boeren	noncompletion	1
verdrage	verdragen	noncompletion	1
ni	niet	noncompletion	3
aren	haren	noncompletion	2
maniere	manieren	noncompletion	3
wa	was	noncompletion	8
wegzette	wegzetten	noncompletion	5
nadoe	nadoet	noncompletion	1
simula	simulator	noncompletion	1
breng	brengt	noncompletion	1
uitgevonde	uitgevonden	noncompletion	1
hoe	hoge	noncompletion	1
ne	ene	noncompletion	1
stokke	stokken	noncompletion	1
slage	slagen	noncompletion	1
drage	dragen	noncompletion	5
boeketas	boekentas	noncompletion	23
alsjeblief	alsjeblieft	noncompletion	3
overschrijve	overschrijven	noncompletion	3
geschreve	geschreven	noncompletion	4
snuffe	snuffen	noncompletion	1
klere	kleren	noncompletion	4
vertale	vertalen	noncompletion	2
bijad	bijhad	noncompletion	1
zwemlesse	zwemlessen	noncompletion	1
rade	raden	noncompletion	2
oe	doet	noncompletion	1
buige	buigen	noncompletion	1
nr	naar	noncompletion	1
strekke	strekken	noncompletion	1
druit	daaruit	noncompletion	1
ik	hik	noncompletion	1
o	zo	noncompletion	1
	ze	noncompletion	3
ak	dak	noncompletion	1
danse	dansen	noncompletion	3
r	daar	noncompletion	1
effecte	effecten	noncompletion	1
liete	lieten	noncompletion	1
speelde	speelden	noncompletion	1
ze	zegt	noncompletion	1
oofdletter	hoofdletter	noncompletion	1
vanda	vandaag	noncompletion	1
helmaal	helemaal	noncompletion	2
broeke	broeken	noncompletion	2
verkorte	verkorten	noncompletion	1
gezwomme	gezwommen	noncompletion	1
inhoue	inhouden	noncompletion	1
gedoke	gedoken	noncompletion	3
aandoe	aandoet	noncompletion	1
vloere	vloeren	noncompletion	1
aanee	aanheeft	noncompletion	1
midde	midden	noncompletion	1
eemaal	helemaal	noncompletion	1
moe	moesten	noncompletion	2
darme	darmen	noncompletion	1
spiere	spieren	noncompletion	1
kikvosmanne	kikvorsmannen	noncompletion	1
val	valt	noncompletion	1
rekene	rekenen	noncompletion	3
ti	tien	noncompletion	1
gelove	geloven	noncompletion	2
zoud	zoude	noncompletion	2
bon	bonk	noncompletion	5
tegegekome	tegengekomen	noncompletion	1
vange	vangen	noncompletion	5
douche	douchen	noncompletion	3
oute	houten	noncompletion	1
gestoke	gestoken	noncompletion	1
rechts	rechtse	noncompletion	1
getrokke	getrokken	noncompletion	1
stampe	stampen	noncompletion	1
ziekenwage	ziekenwagen	noncompletion	2
rieke	rieken	noncompletion	3
mensevlees	mensenvlees	noncompletion	1
gebeure	gebeuren	noncompletion	2
afstaa	afstaat	noncompletion	1
ge	gedaan	noncompletion	1
hoo	hoog	noncompletion	1
t	hebt	noncompletion	1
regele	regelen	noncompletion	1
meepakke	meepakken	noncompletion	2
avos	avonds	noncompletion	1
negenonderd	negenhonderd	noncompletion	1
ka	kat	noncompletion	1
trap	trapt	noncompletion	1
opgenome	opgenomen	noncompletion	1
ronddraaie	ronddraaien	noncompletion	1
he	hebben	noncompletion	2
hadde	hadden	noncompletion	11
zuignappe	zuignappen	noncompletion	1
wa	waren	noncompletion	1
snede	sneden	noncompletion	1
ef	heft	noncompletion	1
eft	heft	noncompletion	1
worme	wormen	noncompletion	1
vie	vies	noncompletion	2
krope	kropen	noncompletion	1
kakke	kakken	noncompletion	2
ee	hebben	noncompletion	1
noem	noemt	noncompletion	1
gestre	gestreken	noncompletion	1
telt	vertelt	noncompletion	1
vertel	vertelt	noncompletion	4
boteramme	boterhammen	noncompletion	2
spulle	spullen	noncompletion	3
leg	legt	noncompletion	1
wange	wangen	noncompletion	1
uitzie	uitziet	noncompletion	2
Kare	Karen	noncompletion	1
veraaltjes	verhaaltjes	noncompletion	2
veraal	verhaal	noncompletion	1
wouwe	wouwen	noncompletion	1
ruike	ruiken	noncompletion	1
boterammen	boterhammen	noncompletion	1
verfpotte	verfpotten	noncompletion	1
de	die	noncompletion	4
konijne	konijnen	noncompletion	2
gra	gras	noncompletion	1
plaatse	plaatsen	noncompletion	1
schoene	schoenen	noncompletion	5
breie	breien	noncompletion	1
musse	mussen	noncompletion	3
doorsnijde	doorsnijden	noncompletion	2
naaie	naaien	noncompletion	2
badpakke	badpakken	noncompletion	1
	is	noncompletion	78
dezelfd	dezelfde	noncompletion	1
zelf	zelfs	noncompletion	2
madamme	madammen	noncompletion	3
buike	buiken	noncompletion	2
spiegelglaze	spiegelglazen	noncompletion	1
tegenhoude	tegenhouden	noncompletion	1
	ik	noncompletion	32
stifte	stiften	noncompletion	5
geweze	gewezen	noncompletion	1
zonde	zonder	noncompletion	1
recepte	recepten	noncompletion	1
plakte	plakten	noncompletion	1
uitlade	uitladen	noncompletion	1
zakke	zakken	noncompletion	2
belone	belonen	noncompletion	1
modelle	modellen	noncompletion	2
drukke	drukken	noncompletion	1
afplukke	afplukken	noncompletion	1
uitrekene	uitrekenen	noncompletion	1
gewete	geweten	noncompletion	1
schijve	schijven	noncompletion	1
zie	zien	noncompletion	1
pianolesse	pianolessen	noncompletion	1
teruggeve	teruggeven	noncompletion	2
amusere	amuseren	noncompletion	1
wegschiete	wegschieten	noncompletion	1
binnekwam	binnenkwam	noncompletion	1
	de	noncompletion	14
afspringe	afspringen	noncompletion	1
geschrokke	geschrokken	noncompletion	1
neutje	nest	explanation	1
herst	deer	explanation	1
ton	bucket	explanation	1
dit	wol	explanation	1
hij	boy	explanation	2
paddestoel	stool	explanation	1
ditte	tape-recorder	explanation	1
eekhoorntje	dog	explanation	1
stier	deer	explanation	1
gewicht	gewei	explanation	1
dit	recorder	explanation	1
zeen	zei	explanation	1
bandje	bankje	explanation	1
dat	deer	explanation	1
watte	wat	replacement	54
efkes	even	replacement	20
te	ge	replacement	68
pak	pakt	replacement	2
tegij	ge	replacement	44
hoor	hoort	replacement	8
de	ge	replacement	346
heb	hebt	replacement	94
gaag	gaat	replacement	1
kom	komt	replacement	13
degij	ge	replacement	128
ken	kent	replacement	21
zie	ziet	replacement	35
kun	kunt	replacement	27
datte	dat	replacement	50
asteblief	alstublieft	replacement	2
ga	gaat	replacement	121
geeft	geef	replacement	1
varkske	varkentje	replacement	1
aan	haan	noncompletion	1
z	is	replacement	1
ander	andere	noncompletion	4
ekik	ik	replacement	6
kinneke	kindje	replacement	23
kinnekes	kindjes	replacement	3
krijk	krijg	replacement	1
kos	kost	noncompletion	1
kost	kunt	replacement	1
vind	vindt	replacement	11
vint	vindt	replacement	2
zeg	zegt	replacement	8
ta	dat	replacement	1
pap	pop	explanation	1
tonderstenboven	ondersteboven	replacement	1
wad	wat	replacement	3
opgeten	opgegeten	noncompletion	21
staag	staat	replacement	1
gee	ga	replacement	1
d	wad	noncompletion	1
zoek	zoekt	replacement	7
verstaan	versta	replacement	2
zul	zult	replacement	2
hon	hond	noncompletion	2
hem	hij	replacement	5
aander	ander	replacement	1
wis	wist	noncompletion	4
maak	maakt	replacement	2
gaad	gaat	replacement	5
hed	hebt	replacement	17
krijg	krijgt	replacement	7
Steve	Steven	noncompletion	1
steef	Steven	replacement	1
plafon	plafond	noncompletion	2
kaske	kastje	replacement	1
e	hebt	noncompletion	1
wadde	wat	replacement	5
oto	auto	replacement	1
koffee	koffie	replacement	1
mak	mag	replacement	4
kik	ik	replacement	2
gaan	ga	replacement	2
botte	botten	noncompletion	6
kijk	kijkt	noncompletion	1
koffe	koffie	noncompletion	1
koffie	koffie	replacement	1
petatjes	patatjes	replacement	9
patatte	patatten	noncompletion	2
snutten	snuiten	replacement	7
dees	deze	replacement	193
wil	wilt	replacement	9
boeke	boeken	noncompletion	25
ek	ik	replacement	6
gesnut	gesnuit	replacement	2
versta	verstaat	replacement	3
tute	tuten	noncompletion	1
bijhouwen	bijhouden	replacement	1
doe	doet	replacement	5
garaag	garage	replacement	9
rijjen	rijden	replacement	8
stinke	stinken	noncompletion	2
ik	ik	replacement	2
reclaam	reclame	replacement	1
oren	horen	noncompletion	1
wijze	wijzen	noncompletion	3
toond	toont	replacement	1
wante	wanten	noncompletion	2
seg	weg	replacement	1
durf	durft	noncompletion	1
weggerejen	weggereden	replacement	1
ritse	ritsen	noncompletion	2
waar	waart	replacement	1
peinz	peinst	replacement	1
val	valt	replacement	2
schreeuw	schreeuwt	noncompletion	1
beesje	beestje	noncompletion	3
camejon	camion	replacement	2
benejen	beneden	replacement	2
dedie	die	replacement	1
heps	hesp	replacement	1
varkjes	varkentjes	replacement	2
varkje	varkentje	replacement	1
optekken	optrekken	noncompletion	1
exaam	examen	replacement	1
toon	toont	replacement	1
ghaald	gehaald	noncompletion	1
asteblieft	alstublieft	replacement	1
kijk	kijkt	replacement	1
petatekes	patatjes	replacement	1
snijjen	snijden	replacement	1
peist	peinst	noncompletion	1
pafel	tafel	explanation	2
teke	tekenen	explanation	3
cola	chocola	explanation	3
ok	slok	explanation	1
tee	tekenen	explanation	1
lo	hallo	explanation	1
valle	gevallen	explanation	1
leze	lezen	explanation	1
poefje	poesje	explanation	1
chilpad	schildpad	explanation	2
chaap	schaap	explanation	5
pape	slapen	explanation	1
chaape	schaap	explanation	1
kijke	kijken	explanation	2
ofant	olifant	explanation	1
poese	poesje	explanation	1
zogen	ogen	explanation	1
vinner	vlinder	explanation	2
bauw	blauw	explanation	2
soel	stoel	explanation	3
dankt	bedankt	explanation	1
armba	armband	explanation	1
komen	aankomen	explanation	3
kaajk	kijk	explanation	1
gogel	vogel	explanation	4
moemen	bloemen	explanation	1
manne	mannen	explanation	1
papapu	paraplu	explanation	1
wammer	warm	explanation	1
di	dit	noncompletion	163
wintels	wimpels	explanation	1
raf	giraf	explanation	1
kiejedil	krokodil	explanation	1
tion	station	noncompletion	3
o	op	noncompletion	10
paard	paard	explanation	1
saks	straks	explanation	1
geluddig	gelukkig	explanation	1
tanborsel	tandenborstel	explanation	1
chouwer	schouder	explanation	1
papoet	kapot	explanation	1
bochting	botsing	explanation	1
suk	stuk	explanation	2
lekel	lepel	explanation	1
vat	vast	noncompletion	1
bele	hele	explanation	1
zwembak	zandbak	explanation	1
kantie	vakantie	explanation	1
pringd	gesprongen	explanation	1
pima	prima	explanation	1
eet	weet	noncompletion	1
eige	eigenlijk	noncompletion	1
pakt	gepakt	explanation	1
peeld	gespeeld	explanation	2
moeiend	vermoeiend	explanation	1
moelend	vermoeiend	explanation	1
chuiven	schuiven	explanation	1
neden	beneden	explanation	3
geval	gevallen	noncompletion	2
kijpen	knijpen	explanation	1
paddes	paddestoel	explanation	1
maakt	gemaakt	explanation	6
Amamiek	Annemiek	explanation	1
amaal	allemaal	explanation	4
panazie	inspiratie	explanation	2
beld	gebeld	explanation	1
kregen	gekregen	explanation	2
kom	komt	explanation	1
pelen	spelen	explanation	21
weest	geweest	explanation	2
dukken	drukken	explanation	2
voor	tegen	explanation	1
boter	boterham	explanation	1
vwat	zwart	explanation	2
bete	beetje	explanation	2
peentje	speentje	explanation	5
i	ik	explanation	1
had	gehad	explanation	1
allem	allemaal	explanation	1
steel	kasteel	explanation	3
pandalen	sandalen	explanation	1
choen	schoen	explanation	3
in	op	explanation	4
dieres	dieren	explanation	3
kijk	dieren	explanation	1
vin	vind	explanation	1
vroren	gevroren	explanation	1
beete	beetje	explanation	1
meer	meneer	explanation	2
saan	staan	explanation	6
emaakt	gemaakt	explanation	1
beuren	gebeuren	explanation	1
man	iemand	explanation	1
pingies	pinguins	explanation	1
vebruiken	gebruiken	explanation	1
uitgelapen	uitgeslapen	explanation	1
mij	ik	explanation	1
pop	op	explanation	1
ha'maal	helemaal	explanation	1
sukje	stukje	explanation	2
soppen	stoppen	explanation	10
kapakeren	parkeren	explanation	1
mijn	jouw	explanation	1
horen	luisteren	explanation	1
zien	kijken	explanation	1
a'maal	allemaal	explanation	2
is	is	explanation	1
geten	vergeten	explanation	1
pas	past	explanation	1
net	niet	explanation	1
chien	misschien	explanation	1
huit	huis	explanation	1
wat	wat	explanation	1
dat	dat	explanation	5
mij	mijn	explanation	5
gevald	gevallen	explanation	1
sallen	stallen	explanation	2
sal	stal	explanation	2
moet	heb	explanation	1
tammarijn	tamboerijn	explanation	1
zeem	zeemonster	explanation	1
zwommen	zwemmen	explanation	1
opgeeten	opgegeten	noncompletion	2
helikoppe	helikopter	explanation	1
me	mijn	explanation	5
helikopt	helikopter	explanation	1
goe	goed	explanation	1
van	op	explanation	2
kant	kan	explanation	3
tellen	vertellen	explanation	4
gaan	gaat	explanation	2
Loof	Roos	explanation	1
serren	sterren	explanation	1
dat	omdat	explanation	5
papot	kapot	explanation	9
elasieken	elastieken	explanation	2
potjes	poppetjes	explanation	1
zine	benzine	explanation	1
vuilwagen	vuilniswagen	explanation	1
schoente	schoenen	explanation	1
paaggaat	spagaat	explanation	1
krondje	rondje	explanation	1
papo	kapot	explanation	1
gogels	vogels	explanation	1
viezeret	sigaret	explanation	1
over	boven	explanation	1
hemaal	helemaal	noncompletion	11
slis	slip	explanation	1
dramen	ramen	explanation	2
eigen	eigenlijk	explanation	1
kijkt	krijgt	explanation	1
poleem	probleem	explanation	1
plast	past	explanation	1
ie	zij	explanation	1
schoordeen	schoorsteen	explanation	1
gesolten	gesmolten	explanation	1
Grooi	Groningen	explanation	1
wal	walvis	explanation	1
doel	bedoel	explanation	1
saat	staat	explanation	2
zin	verzin	explanation	1
lenuh	lenen	explanation	1
pasoppen	oppassen	explanation	1
zichtig	voorzichtig	explanation	1
sukjes	stukjes	explanation	2
gesort	neergestort	explanation	1
vlieg	vliegtuig	explanation	1
zwarre	zwarte	explanation	5
maptoren	motoren	explanation	1
gaat	gaan	explanation	1
manazie	spinazie	explanation	1
panazie	spinazie	explanation	1
sokbrood	stokbrood	explanation	3
vetalen	betalen	explanation	3
stokbrood	stokbrood	explanation	1
seepjes	streepjes	explanation	2
hij	hem	explanation	1
ans	anders	explanation	2
radi	radio	explanation	1
sation	station	explanation	1
sjon	station	explanation	8
door	onderdoor	explanation	2
schevig	stevig	explanation	1
mouwen	bouwen	explanation	1
zul	zullen	explanation	2
vlouwtje	vrouwtje	explanation	1
zijn	haar	explanation	2
van	in	explanation	1
ie	ze	explanation	2
zto	zo	explanation	1
meer	weer	explanation	1
van	aan	explanation	1
hem	hij	explanation	1
horen	recorder	explanation	1
veel	heel	explanation	1
suimer	suiker	explanation	1
in	erin	explanation	1
geroon	gewoon	explanation	2
zo	vanzelf	explanation	2
mogelijg	mogelijk	explanation	1
kinder	kind	explanation	1
kinder	kinderen	explanation	1
pring	spring	explanation	3
geprongd	gesprongen	explanation	2
meememen	meenemen	explanation	3
vrast	vast	explanation	1
ymastieken	gymnastiek	explanation	2
tleke	trekker	explanation	1
tete	tekenen	explanation	1
mewe	banaan	explanation	1
mijme	banaan	explanation	1
hume	hamer	explanation	1
amer	hamer	noncompletion	4
paat	paard	explanation	1
it	kip	explanation	1
dich	dicht	noncompletion	35
ame	hamer	explanation	1
kuk	sok	explanation	1
ses	fles	explanation	3
eeg	leeg	noncompletion	1
fesje	flesje	noncompletion	3
ta	eendje	explanation	1
tore	toren	noncompletion	1
boek	broek	noncompletion	3
eebt	hemd	explanation	1
towet	tomaat	explanation	1
aapoche	aardappel	explanation	1
	mes	explanation	1
pik	prik	noncompletion	1
ip	kip	noncompletion	1
nut	muts	explanation	1
gijewem	glijbaan	explanation	1
egoog	vliegtuig	explanation	1
eete	eendje	explanation	1
eme	zwemmen	explanation	1
zeme	zwemmen	explanation	1
goen	groen	noncompletion	3
bauw	blauw	noncompletion	3
jijjen	rijden	explanation	1
pop	dop	explanation	1
mpietje	papiertje	explanation	1
esss	fles	explanation	1
ope	open	explanation	1
ove	open	explanation	1
dieg	dicht	explanation	1
kikke	knikker	explanation	3
kijch	kijk	explanation	1
eboot	kapot	explanation	1
doo	deur	explanation	1
koes	slapen	explanation	1
daanin	daarin	explanation	1
hejeeg	leeg	explanation	1
pom	boom	explanation	1
pich	pink	explanation	1
bokke	blokken	explanation	1
mote	mondje	explanation	1
hawe	halen	explanation	1
	op	noncompletion	10
nikke	knikker	noncompletion	1
kikker	knikker	noncompletion	2
ovig	open	explanation	1
kikke	drinken	explanation	1
kinke	drinken	explanation	2
mooitfiets	motorfiets	explanation	1
timmenel	timmeren	explanation	1
timmenau	timmeren	explanation	1
sokje	stokje	noncompletion	1
ko	koffie	noncompletion	1
suude	stuur	explanation	1
gokje	stokje	explanation	1
ging+gen	drinken	explanation	1
kiete	kietelen	noncompletion	8
erin	erin	explanation	1
potloo	potlood	noncompletion	1
mech	met	explanation	1
hoot	rood	explanation	1
anse	mensen	explanation	1
tet	flat	explanation	1
set	flat	explanation	1
ooe	oor	explanation	1
piegel	spiegel	noncompletion	2
iegel	spiegel	noncompletion	1
panien	Paulien	explanation	2
piege	spiegel	noncompletion	1
foon	koptelefoon	noncompletion	1
ieche	spiegel	explanation	1
bie	bril	explanation	1
bil	bril	noncompletion	7
booitje	broodje	explanation	1
boodje	broodje	noncompletion	1
maat	zwaard	explanation	1
waak	zwaard	explanation	1
goog	vogel	explanation	1
paadje	paardje	noncompletion	22
gein	trein	explanation	1
chome	schommel	explanation	1
chommel	schommel	noncompletion	1
pesies	precies	explanation	1
otat	olifant	explanation	1
bostel	wortel	explanation	1
mannikt	markt	explanation	1
gag	vlag	explanation	1
kest+seel	kasteel	explanation	1
zlage	zaag	explanation	1
woeof	schroef	explanation	1
soefewaaie	schroevedraaier	explanation	1
eetje	eendje	explanation	2
tamemole	draaimolen	explanation	1
oolfajtje	olifantje	explanation	1
boek	broek	explanation	4
kaanwa	kraanwagen	noncompletion	1
ijen	rijden	noncompletion	1
hije	rijden	explanation	2
lau	ladder	explanation	1
ohoog	omhoog	noncompletion	1
huve	schuiven	explanation	1
uiche	schuiven	explanation	1
euke	drukken	explanation	1
dat	daar	explanation	66
tesje	flesje	explanation	1
seppies	schepjes	explanation	1
kij	kijk	noncompletion	13
bot	kapot	explanation	1
epot	kapot	explanation	1
konijn	koning	explanation	1
tamole	draaimolen	explanation	1
kopt	geklopt	noncompletion	1
	in	noncompletion	8
kikkes	knikkers	explanation	2
timme	timmeren	noncompletion	6
tage	zagen	explanation	1
vuiseappe	vuilnisauto	explanation	1
grazje	garage	explanation	1
woog	hoog	explanation	1
tok	slok	explanation	1
ginke	drinken	explanation	2
kein	trein	explanation	1
Tam	Daan	explanation	2
teweh	verven	explanation	1
panmd	zand	explanation	1
gingke	drinken	explanation	1
solly	sorry	explanation	1
pannom	ballon	explanation	1
tellef	verf	explanation	1
Ota	Oscar	explanation	1
tolly	sorry	explanation	1
pu	paraplu	explanation	2
	er	noncompletion	20
chiechuich	vliegtuig	explanation	1
eikoee	eekhoorn	explanation	1
hege	regen	explanation	1
ehgkkaa	Sinterklaas	explanation	1
anne	ander	explanation	3
teje	pellen	explanation	1
kaam	kraan	explanation	1
ofawtje	olifantje	explanation	2
mookte	motor	explanation	1
Ber	Bert	noncompletion	1
paa	paard	noncompletion	4
og	nog	noncompletion	3
pas	past	noncompletion	11
ma	nou	explanation	1
ofantje	olifantje	noncompletion	1
kikkers	knikkers	noncompletion	2
toel	stoel	noncompletion	29
sjifow	shovel	explanation	1
kraam	kraan	explanation	1
kim	klim	noncompletion	1
otaa	Oscar	explanation	1
paad	paard	noncompletion	34
koelke	koelkast	explanation	1
toeke	zoeken	explanation	1
kan	kraan	explanation	1
koptje	kopje	explanation	1
gasje	garage	explanation	1
potood	potlood	noncompletion	18
seeuw	sneeuw	noncompletion	15
alle	allemaal	noncompletion	6
]	slee	explanation	1
hongetje	jongetje	explanation	1
pakt	plakt	noncompletion	1
pring	spring	noncompletion	1
	voor	noncompletion	7
tukje	stukje	noncompletion	4
maakt	gemaakt	noncompletion	63
pot	kapot	noncompletion	129
	van	noncompletion	12
Sinterkaas	Sinterklaas	noncompletion	5
kas	klas	noncompletion	1
tokekaa	Sinterklaas	explanation	1
taf	staf	noncompletion	6
paar	paard	noncompletion	2
lapot	kapot	explanation	1
kijke	strijken	explanation	1
pint	pen	explanation	1
pent	pen	explanation	1
potlood	potlood	explanation	1
]	terug	explanation	1
vinges	vingers	noncompletion	2
keure	kleuren	explanation	1
appeboom	appelboom	noncompletion	2
kieen	knieen	noncompletion	1
vvvvieger	vlieger	explanation	1
choonmake	schoonmaken	explanation	1
keien	kleien	noncompletion	6
oppakken	opplakken	noncompletion	12
ollen	rollen	noncompletion	2
pakke	plakken	explanation	5
pochke	plakken	explanation	1
kei	klei	noncompletion	2
hoot	hoort	noncompletion	2
liebeestje	lieveheersbeestje	explanation	1
och	ook	explanation	1
saf	staf	noncompletion	1
kamme	kamer	explanation	1
gove	koffer	explanation	1
vieger	vlieger	noncompletion	1
pimme	klimmen	explanation	1
tehekke	trekker	explanation	1
ijk	kijk	noncompletion	1
aend	arend	noncompletion	1
tekenitje	tekeningetje	noncompletion	1
panie	Paulien	explanation	1
ansow	andersom	explanation	1
tlop	erop	explanation	1
keeboo	kerstboom	explanation	1
keeboom	kerstboom	explanation	1
ke	kijk	explanation	1
	stukjes	noncompletion	1
	rails	noncompletion	1
rone	ronde	noncompletion	1
vacht	vracht	noncompletion	1
vachage	vrachtwagen	explanation	1
k	kan	noncompletion	1
toplich	stoplicht	noncompletion	1
zjon	station	explanation	1
krein	trein	explanation	1
niees	niet	explanation	1
deheje	deze	explanation	1
t	moet	noncompletion	7
uitappe	uitstappen	explanation	1
krei	trein	explanation	1
waguige	vrachtwagen	explanation	1
eers	eerst	noncompletion	11
dlop	erop	explanation	1
bok	blok	noncompletion	2
bokjes	blokjes	noncompletion	1
otte	helikopter	explanation	1
giese	gitaar	explanation	1
oo	ook	noncompletion	30
	wat	noncompletion	29
te	tekenen	noncompletion	2
sjaa	shawl	explanation	1
ka	kaarten	noncompletion	1
koesen	slapen	explanation	4
sapen	slapen	noncompletion	2
li	ligt	explanation	1
wel	welke	noncompletion	1
	stukken	noncompletion	1
onerva	onervaren	noncompletion	1
afvalt	afgevallen	explanation	1
settuur	stuur	explanation	1
de	Daan	explanation	1
pug	brug	explanation	1
ig	lig	noncompletion	1
mee	met	explanation	1
&zik	zit	explanation	1
menk	melk	explanation	1
chaap	schaap	noncompletion	4
sor	snor	noncompletion	2
	geen	noncompletion	1
keine	kneden	explanation	1
	moet	noncompletion	7
kijpen	knijpen	noncompletion	1
ane	andere	noncompletion	4
dat	zodat	noncompletion	3
kreden	kneden	explanation	1
ousette	uitzetten	explanation	1
wal	walvis	noncompletion	1
biewtje	wieltje	explanation	1
&bleu	deur	explanation	1
beeuwtje	wieltje	explanation	1
beetje	wieltje	explanation	1
pokmaken	kapotmaken	explanation	1
kapotmaakt	kapotgemaakt	noncompletion	1
potmaakt	kapotmaakt	noncompletion	1
velf	verf	explanation	1
kijkkoekoel+foon	koptelefoon	explanation	1
kelekoediefoon	koptelefoon	explanation	1
peelt	speelt	noncompletion	1
politiegent	politieagent	noncompletion	2
tor	motor	explanation	1
al	allemaal	noncompletion	4
ka	kan	noncompletion	10
luk	lukt	noncompletion	1
	over	noncompletion	1
ok	op	explanation	1
goofie	koffie	explanation	1
telefoonkoch	koptelefoon	explanation	1
koptefoon	koptelefoon	noncompletion	1
vullen	smullen	explanation	1
kregen	gekregen	noncompletion	14
bieuw	wiel	explanation	1
vlachaat	vrachtwagen	explanation	1
oof	op	explanation	1
bieuwtoe	wieltje	explanation	1
biel	wiel	explanation	1
poli	politie	noncompletion	1
sture	stuur	explanation	1
saaiig	zwaailicht	explanation	1
kaa	klaar	explanation	1
aujeoband	olifant	explanation	1
vonden	gevonden	noncompletion	6
&dele	de	explanation	1
boerij	boerderij	noncompletion	10
na	naast	noncompletion	1
ama	allemaal	noncompletion	2
saapkamer	slaapkamer	noncompletion	1
does	douche	explanation	1
	kruimeldief	explanation	1
appetje	appeltje	noncompletion	2
meie	meisje	noncompletion	1
kere	klere	noncompletion	1
opdrogen	afdrogen	explanation	1
be	bed	noncompletion	1
keren	kleren	noncompletion	1
balenen	wandelen	explanation	1
pelen	spelen	noncompletion	13
puitje	spuitje	noncompletion	1
peister	pleister	noncompletion	1
peis	pleister	noncompletion	1
deefe	deze	explanation	1
moto	motor	noncompletion	1
la	laat	noncompletion	10
weest	geweest	noncompletion	16
saat	staat	noncompletion	1
gazen	glazen	noncompletion	2
troop	stroop	noncompletion	3
kekregen	gekregen	explanation	1
fies	fiets	noncompletion	3
	heeft	noncompletion	2
pepot	kapot	explanation	2
potemaakt	kapotgemaakt	explanation	1
okemaken	openmaken	explanation	1
e	even	noncompletion	5
jou	jij	explanation	1
zoek	zoeken	noncompletion	1
chillen	schillen	noncompletion	2
flis	fris	explanation	1
leppe	knippen	explanation	1
achlippe	afknippen	explanation	1
	doen	noncompletion	6
omaken	openmaken	noncompletion	1
vaarlijk	gevaarlijk	noncompletion	10
welk	welke	noncompletion	1
a	is	explanation	1
ranje	oranje	explanation	1
rojanje	oranje	explanation	1
chreeuwt	schreeuwt	noncompletion	1
chreeuw	schreeuw	noncompletion	1
ieri	hierin	explanation	1
vadrage	vrachtwagen	explanation	1
deu	deur	noncompletion	10
ruit	eruit	noncompletion	4
&roberen	proberen	explanation	1
popot	kapot	explanation	1
dee	deze	noncompletion	4
soeballen	voetballen	explanation	1
he	heb	noncompletion	17
	we	noncompletion	7
Ros	Rosa	noncompletion	2
vooz	voorzichtig	explanation	1
	jij	noncompletion	2
suiven	schuiven	noncompletion	1
kuiven	schuiven	explanation	1
chuiven	schuiven	noncompletion	1
vaarlijke	gevaarlijke	noncompletion	8
tekened	getekend	explanation	2
beej	beetje	explanation	1
plukt	geplukt	noncompletion	1
teke	tekening	noncompletion	1
m	moet	noncompletion	3
spuwen	schieten	explanation	1
h	heel	noncompletion	1
moet	moest	explanation	1
oges	oogjes	explanation	1
zit	zitten	noncompletion	7
ta	tafel	noncompletion	2
eif	eigen	explanation	1
kippes	kippen	explanation	1
deje	deze	explanation	1
oogk	ook	explanation	1
kaartje	karretje	explanation	1
kaarsje	karretje	explanation	1
kartj	karretje	explanation	1
ach	achter	noncompletion	3
hen	helm	explanation	1
nanner	ladder	explanation	1
hempje	helmpje	noncompletion	1
spieuw	spuit	explanation	1
blust	geblust	noncompletion	1
chool	school	noncompletion	3
fuurtjes	figuurtjes	noncompletion	1
soepballen	voetballen	explanation	1
	naar	noncompletion	3
e	een	noncompletion	14
kuidief	kruimeldief	noncompletion	1
kluidief	kruimeldief	explanation	1
paplu	paraplu	noncompletion	4
wortes	wortel	explanation	1
koor	koren	explanation	1
schilderd	opgeschilderd	noncompletion	1
opeklakt	opgeplakt	explanation	1
win	winkel	noncompletion	1
kleure	gekleurde	noncompletion	1
	dit	noncompletion	3
mo	molen	noncompletion	1
snaan	zwaan	explanation	1
slulf	slurf	explanation	1
zaan	zwaan	noncompletion	1
gaan	gegaan	noncompletion	2
voor	van	explanation	10
opaan	opgedaan	noncompletion	1
meisj	meisje	noncompletion	6
kinren	kinderen	noncompletion	1
bink	duim	explanation	1
	om	noncompletion	1
	bij	noncompletion	3
	ie	noncompletion	1
opop	op	explanation	1
mo	motor	noncompletion	1
daan	gedaan	noncompletion	58
rop	erop	noncompletion	5
slaas	slaapkamer	explanation	1
krast	gekrast	noncompletion	3
vrachtdragen	vrachtwagen	explanation	1
zelf	zelfde	noncompletion	1
skieten	schieten	explanation	1
emaakt	gemaakt	noncompletion	10
dezet	deze	explanation	1
sap	snap	noncompletion	1
	zo	noncompletion	1
circ	circus	noncompletion	2
waren	bewaren	noncompletion	3
vietui	vliegtuig	explanation	1
li	ligt	noncompletion	1
o	oma	noncompletion	4
vistig	voorzichtig	explanation	1
daaan	dan	explanation	1
zul	zullen	noncompletion	4
aansom	andersom	explanation	1
mook	ook	explanation	1
	aan	noncompletion	5
keerd	verkeerd	noncompletion	5
die	wat	explanation	3
eplakt	geplakt	noncompletion	1
smeer	smeert	noncompletion	1
ame	allemaal	explanation	2
vichtig	voorzichtig	noncompletion	1
j	ja	noncompletion	1
ge	gaan	explanation	1
kroetje	koekje	explanation	1
ooievant	olifant	explanation	1
luister	luisteren	noncompletion	2
w	wat	noncompletion	9
spingen	springen	noncompletion	1
rosaachte	rolschaatsen	explanation	1
Pau	Paulien	noncompletion	1
ge	zijn	explanation	1
soeballe	voetballen	explanation	1
dik	dit	explanation	1
ezien	gezien	noncompletion	4
kannet	kant	explanation	1
raceto	raceauto	noncompletion	1
racechauto	raceauto	explanation	1
loge	horloge	noncompletion	13
hoe	hoeft	noncompletion	1
of	op	explanation	1
raceau	raceauto	noncompletion	1
instopt	ingestopt	noncompletion	1
aard	aardig	noncompletion	1
t	wat	noncompletion	108
d	daar	noncompletion	1
koest	slaapt	explanation	2
ger	hoger	noncompletion	1
	dan	noncompletion	4
aane	andere	explanation	1
astenaut	astronaut	explanation	1
meem	neem	explanation	1
helekotte	helikopter	explanation	1
wolke	golven	explanation	1
Lid	Lidewij	noncompletion	1
xxbeut	boot	explanation	1
eslapen	geslapen	noncompletion	1
dezien	gezien	explanation	1
zemmen	zwemmen	noncompletion	1
hoof	hoofd	noncompletion	9
dewees	geweest	explanation	2
	stukje	noncompletion	1
mee	neem	explanation	1
soetballe	voetballen	explanation	1
pa	papa	noncompletion	1
gewollen	gezwommen	explanation	1
chelpen	schelpen	noncompletion	1
vagen	gegraven	explanation	1
geplast	geblazen	explanation	1
vlinde	vinden	explanation	3
je	mijn	explanation	1
	mee	noncompletion	3
z	zit	noncompletion	2
snemmen	zwemmen	explanation	1
hama	allemaal	explanation	1
men	meneer	explanation	1
nekken	hekken	explanation	2
	pak	noncompletion	1
	zelf	noncompletion	1
ande	andere	noncompletion	6
ovreen	overheen	explanation	1
boede	bedoel	explanation	1
bigjes	biggetjes	explanation	1
ə	is	explanation	1
wi	wil	noncompletion	61
ma	mam	noncompletion	1
van	voor	explanation	5
bee	beetje	noncompletion	3
	eng	noncompletion	1
bakken	gebakken	noncompletion	2
	opeten	noncompletion	1
gone	gewone	noncompletion	2
spieuwen	schieten	explanation	1
spiewen	schieten	explanation	1
wor	hoort	explanation	1
	grond	noncompletion	2
evallen	gevallen	noncompletion	5
nog	ook	explanation	1
dennis	tennis	explanation	1
wordt	hoort	explanation	4
drukken	trekken	explanation	1
op	opgegeten	noncompletion	1
fruit	perzik	explanation	1
kaasje	kaarsje	noncompletion	1
n	nog	noncompletion	2
geneest	geweest	explanation	1
lig	leg	explanation	1
wat	waar	explanation	3
moeilke	moeilijkste	explanation	1
woord	hoort	explanation	1
woort	hoort	explanation	1
daar	daardoor	explanation	1
tje	bootje	explanation	1
sol	parasol	noncompletion	1
padesol	parasol	explanation	1
awelappe	aardappel	explanation	1
	die	noncompletion	5
	bel	noncompletion	1
	blazen	noncompletion	1
moet	moeten	noncompletion	3
	zien	noncompletion	1
	doet	noncompletion	2
ka	kamer	noncompletion	2
ja	nee	explanation	1
	twee	noncompletion	1
	morgens	noncompletion	1
domi	domino	noncompletion	1
	doe	noncompletion	1
de	denk	noncompletion	1
mwa	waar	explanation	1
&bebrene	beneden	explanation	1
bebrene	beneden	explanation	1
fil	filters	noncompletion	1
wol	wolf	noncompletion	2
gile	gilde	noncompletion	1
do	dorst	noncompletion	1
brande	verbrande	noncompletion	1
doen	maken	explanation	1
aatrarepaat	acrobaat	explanation	1
gling	gleed	explanation	2
ogerden	ogen	explanation	1
kruimel	kruimeldief	noncompletion	1
ligo	lego	explanation	1
	brand	noncompletion	1
ane	andere	explanation	1
bin	binnen	noncompletion	1
	en	noncompletion	38
	biggetjes	noncompletion	1
chapen	schapen	noncompletion	1
tante	tanden	explanation	1
woloh	wolf	explanation	1
over	overal	noncompletion	1
wort	wortel	noncompletion	1
meer	meneer	noncompletion	2
	drinken	noncompletion	1
geschreeft	geschreven	explanation	1
gee	geel	noncompletion	3
groen	groente	noncompletion	1
	kant	noncompletion	1
fon	fontein	noncompletion	1
opegeten	opgegeten	noncompletion	2
sachzuigen	stofzuigen	explanation	2
hem	heb	explanation	2
dennis	tennisracket	explanation	1
	geven	noncompletion	1
sijen	snijden	noncompletion	1
gestookt	gestoken	explanation	1
holen	horen	explanation	1
pak	pakken	noncompletion	9
zet	zetten	noncompletion	1
woesje	poesje	explanation	1
ploesje	poesje	explanation	1
m	maar	noncompletion	1
	zei	noncompletion	2
	hij	noncompletion	2
pitool	pistool	noncompletion	1
pringen	springen	noncompletion	1
ij	kijk	noncompletion	1
bigje	biggetje	noncompletion	1
zelf	zichzelf	noncompletion	1
kinde	kinderen	noncompletion	5
leen	alleen	noncompletion	25
neden	kneden	noncompletion	1
gaat	ging	explanation	1
mioscoop	bioscoop	explanation	1
von	vond	noncompletion	19
pallestoel	paddestoel	explanation	1
nijn	konijn	noncompletion	18
teken	tekenen	noncompletion	12
tek	tekening	noncompletion	1
sui	snuiten	explanation	1
konijn	gordijn	explanation	1
kukə	koekjes	replacement	1
kukəs	koekjes	replacement	1
piertje	papiertje	noncompletion	17
lood	potlood	noncompletion	1
luiste	luisteren	noncompletion	8
keuk	keuken	noncompletion	4
da	das	noncompletion	2
soot	schoot	noncompletion	4
ablieft	alsjeblieft	noncompletion	1
ziek	muziek	noncompletion	12
wart	zwart	noncompletion	1
tietoo	toeter	explanation	1
kokodillen	krokodillen	noncompletion	1
krij	krijgen	noncompletion	1
voetjesjes	voetjes	explanation	1
ech	echt	noncompletion	2
neeuw	sneeuw	noncompletion	2
boeke	boekje	noncompletion	10
lez	lezen	noncompletion	1
daarbov	daarboven	noncompletion	1
goo	gooien	noncompletion	1
zu	zullen	noncompletion	11
	fles	explanation	2
drink	drinken	noncompletion	2
waai	lawaai	noncompletion	16
plakt	geplakt	noncompletion	2
	dat	explanation	5
	mooi	explanation	1
&pəlilisjə	papiertje	explanation	1
slapen	geslapen	noncompletion	1
lon	ballon	noncompletion	2
	Evelien	explanation	1
nijl	nijlpaard	explanation	2
evaarlijk	gevaarlijk	noncompletion	1
s	es	noncompletion	6
wanen	zwanen	noncompletion	3
f	heef	noncompletion	5
aflopen	afgelopen	noncompletion	3
mons	monsters	noncompletion	1
bijv	bijvoorbeeld	noncompletion	1
dit	baby	explanation	1
aand	aandrijving	noncompletion	1
losla	loslaten	noncompletion	1
beurt	gebeurt	noncompletion	26
neer	meneer	noncompletion	20
	i	noncompletion	5
glijen	glijden	noncompletion	6
schien	misschien	noncompletion	7
I	Iris	noncompletion	1
ander	anders	noncompletion	2
singen	springen	noncompletion	1
zichtje	gezichtje	noncompletion	6
	varken	explanation	1
ever	bever	noncompletion	1
st	strikken	noncompletion	1
bales	balletjes	noncompletion	1
ses	prinses	noncompletion	6
toete	toeteren	noncompletion	1
kantie	vakantie	noncompletion	11
ve	even	noncompletion	1
smak	smakelijk	noncompletion	1
drin	drinken	noncompletion	1
appels	aardappels	noncompletion	1
aarpels	aardappels	noncompletion	2
hoofje	hoofdje	noncompletion	2
vark	varken	noncompletion	19
al	alle	noncompletion	2
visie	televisie	noncompletion	4
vee	teevee	noncompletion	1
vas	vast	noncompletion	5
centj	centje	noncompletion	2
bees	beest	noncompletion	3
wees	geweest	noncompletion	3
anersom	andersom	noncompletion	6
geha	gehaald	noncompletion	1
hoef	hoeft	noncompletion	8
nijnen	konijnen	noncompletion	3
afblijv	afblijven	noncompletion	1
blik	ogenblik	noncompletion	1
klopjes	knopjes	explanation	1
schrij	schrijven	noncompletion	1
tellen	vertellen	noncompletion	18
pla	plasje	noncompletion	1
pier	papier	noncompletion	11
velen	vervelend	noncompletion	1
k	keer	noncompletion	1
krodil	krokodil	noncompletion	1
eworden	geworden	noncompletion	2
beren	proberen	noncompletion	8
ekocht	gekocht	noncompletion	1
lach	lacht	noncompletion	2
koch	kocht	noncompletion	2
druk	drukken	noncompletion	2
zet	gezet	noncompletion	6
puter	computer	noncompletion	1
leg	leggen	noncompletion	2
edoeld	bedoeld	noncompletion	1
eplast	geplast	noncompletion	1
stoppen	verstoppen	noncompletion	4
ehoest	gehoest	noncompletion	1
ebruiken	gebruiken	noncompletion	5
afedroogd	afgedroogd	noncompletion	1
eweest	geweest	noncompletion	4
&pajpia	paprika	explanation	1
hee	heef	noncompletion	2
wegge	weggetje	noncompletion	1
pelletje	spelletje	noncompletion	11
aanzet	aangezet	noncompletion	4
edaan	gedaan	noncompletion	27
kwijteraakt	kwijtgeraakt	noncompletion	1
ment	moment	noncompletion	1
eventje	eventjes	noncompletion	2
bekij	bekijken	noncompletion	1
luid	geluid	noncompletion	3
za	zal	noncompletion	11
meeenomen	meegenomen	noncompletion	1
geven	gegeven	noncompletion	2
wor	wordt	noncompletion	3
lazen	blazen	explanation	1
ballen	vallen	explanation	1
proken	afgesproken	explanation	1
deez	deze	explanation	1
rage	garage	explanation	1
rink	springt	explanation	1
and	hand	explanation	2
pok	kop	explanation	1
peen	speen	explanation	10
pesap	appelsap	explanation	1
zaggedoek	zakdoek	explanation	1
foon	microfoon	explanation	1
fifofoon	microfoon	explanation	1
knoeid	geknoeid	explanation	2
kossie	koffie	replacement	1
poolood	potlood	explanation	1
stoten	gestoten	explanation	2
	k	noncompletion	2
voo	voor	explanation	1
graag	begraven	explanation	1
cheppen	scheppen	explanation	3
pecelaasje	speculaasje	explanation	1
loeien	roeren	explanation	1
loere	roeren	explanation	1
kof	koffie	explanation	1
keuke	keuken	explanation	1
dronken	opgedronken	explanation	2
klepeltje	lepeltje	explanation	3
ballom	ballon	explanation	1
fant	olifant	explanation	1
bakje	gebakje	explanation	1
pilpad	schildpad	explanation	2
krotekril	krokodil	explanation	1
om	onder	explanation	4
laasie	speculaasje	explanation	1
Net	Jeanet	explanation	1
pipielaasje	speculaasje	explanation	1
vaarlijk	gevaarlijk	explanation	2
kikefoon	microfoon	explanation	1
Gerard	afblijven	explanation	1
saapkamers	slaapkamers	explanation	1
klepel	lepel	explanation	1
dachtig	aandachtig	explanation	1
loeren	roeren	explanation	5
kouden	verkouden	explanation	1
suikerrandje	suikerklontje	explanation	2
plekelaasje	speculaasje	explanation	1
stikje	elastiekje	explanation	2
mand	niemand	explanation	1
noeg	genoeg	explanation	4
Anke	Hanneke	explanation	1
bugge	buggy	explanation	1
pohorloge	polshorloge	noncompletion	1
naut	nat	explanation	1
pijker	spijker	explanation	1
ij	jij	explanation	1
genoeid	geknoeid	explanation	1
pannend	spannend	explanation	1
opdronken	opgedronken	noncompletion	1
gazandteel	zandkasteel	explanation	1
papot	kapot	replacement	4
choonmaakt	schoongemaakt	explanation	1
aflingblieft	alsjeblieft	explanation	1
iskantie	vakantie	explanation	1
verfkijker	verrekijker	explanation	1
chore	geschoren	explanation	1
kij	kijk	explanation	1
eigervogel	reiger	explanation	1
duitplank	duikplank	explanation	1
duitsland	duikplank	explanation	1
duisplank	duikplank	explanation	1
rote	rode	replacement	1
duitsplank	duikplank	explanation	1
stoestand	toestand	explanation	1
chaften	schaften	explanation	1
tafel	imperatief	explanation	1
spoetsten	poetsen	explanation	1
sor	professor	explanation	2
defessor	professor	explanation	1
sofessor	professor	explanation	1
Stein	Einstein	explanation	1
tup	put	explanation	2
fordijn	gordijn	explanation	1
boemen	bloemen	explanation	2
vin	vindt	explanation	2
garagie	garage	explanation	1
ke	de	explanation	1
lig	liggen	explanation	1
heef	heeft	explanation	6
passen	plassen	explanation	1
tekend	getekend	explanation	3
weetend	weekend	explanation	1
fotostel	fototoestel	explanation	1
ansap	appelsap	explanation	1
opraken	opruimen	explanation	1
ammele	allemaal	explanation	1
net	Jeanet	explanation	1
teken	tekenen	explanation	1
stik	strik	explanation	2
buit	buik	explanation	1
poe	poes	explanation	2
teken	tekent	explanation	1
poppenee	portemonnaie	explanation	1
heeschoepen	hefschroeven	explanation	1
stuurt	stuurtje	explanation	1
ret	rest	explanation	1
stoten	botsen	explanation	1
plepeltje	lepeltje	explanation	1
boksing	botsing	explanation	1
een	heen	explanation	1
makes	maken	explanation	1
heerd	gerepareerd	explanation	1
tepereerd	gerepareerd	explanation	1
doet	doen	explanation	2
steefte	stevig	explanation	1
is	anders	explanation	2
armpe	armpje	explanation	1
ligt	lift	explanation	1
gestoppen	gestopt	explanation	1
deurt	deur	explanation	1
steel	kasteel	noncompletion	1
bak	zitten	explanation	1
zo	zo'n	explanation	1
die	dat	explanation	1
gestukt	geknipt	explanation	1
die	daar	explanation	1
als	zoals	explanation	1
bazen	blazen	explanation	1
zeg	zegt	explanation	1
op	in	explanation	1
wast	was	explanation	1
hang	hangen	explanation	1
wasde	was	explanation	1
snip	snipverkouden	explanation	1
meziek	muziek	explanation	1
geloopt	gelopen	explanation	1
geloopte	gelopen	explanation	1
drinken	nomen	explanation	1
jij	jou	explanation	2
mij	imperatief	explanation	1
stschoonsveger	straatveger	explanation	1
eens	imperatief	explanation	1
wasse	waren	explanation	3
boden	boten	explanation	2
hoor	imperatief	explanation	1
op	imperatief	explanation	1
kuns	kunst	explanation	1
fafond	plafond	explanation	1
kante	kunnen	explanation	1
dat	die	explanation	1
weg	imperatief	explanation	1
spin	imperatief	explanation	1
opvegeten	opgegeten	explanation	1
vangen	gevangen	explanation	1
toenwassen	waren	explanation	1
ganen	gaan	explanation	1
paardje	imperatief	explanation	1
om	omdat	explanation	4
skietelen	kietelen	explanation	1
geworden	worden	explanation	1
grote	groot	explanation	1
gevond	gevonden	explanation	1
wassen	waren	explanation	1
vember	november	explanation	1
loer	roer	explanation	1
krijg	kan	explanation	1
boksen	botsen	explanation	1
in	imperatief	explanation	1
ketstaaf	banketstaaf	explanation	1
auto	deur	explanation	1
Indiaan	Italiaan	explanation	1
ie	kijken	explanation	1
sloer	snoer	explanation	1
openmaken	imperatief	explanation	1
stukke	kapotte	explanation	2
stukke	kapot	explanation	1
blallon	ballon	explanation	1
lussen	lusten	explanation	1
zondig	zonde	explanation	1
kaka	vogel	explanation	3
jak	zak	explanation	1
	Max	explanation	1
	hond	explanation	2
	koek	explanation	2
ts	schoot	explanation	1
het	schoot	explanation	2
	vlekken	explanation	1
	kindje	explanation	3
wawa	hond	explanation	1
	koekje	explanation	1
	roeren	explanation	1
	bad	explanation	2
	uur	explanation	1
ta	auto	explanation	1
	auto	explanation	2
	rijden	explanation	3
ku	koek	replacement	1
	vissen	explanation	1
	shampoo	explanation	1
	kussen	explanation	1
	drinken	explanation	1
	Thijs	explanation	2
k	muziek	explanation	3
maulen	rozijnen	explanation	3
	duplo	explanation	2
	Harry	explanation	2
	elkaar	explanation	1
n	telefoon	explanation	1
	muziek	explanation	1
	lezen	explanation	4
&ewə	hebben	explanation	1
	sturen	explanation	3
xi	jarig	explanation	1
xə	jarig	explanation	2
&semə	zwemmen	explanation	1
	ziekenauto	explanation	1
me	melk	noncompletion	1
	heb	noncompletion	4
	meeuwen	explanation	1
zak	zakdoek	noncompletion	3
&bus	blouse	explanation	1
uilese	uitgelezen	explanation	1
	doek	explanation	1
	mevrouw	explanation	2
	popje	explanation	1
	daar	noncompletion	2
	rozijntje	explanation	1
	trein	explanation	5
dypo	duplo	explanation	1
po	duplo	explanation	1
	paraplu	explanation	1
m	oma	explanation	1
n	staan	explanation	1
	timmeren	explanation	3
tjə	piemeltje	explanation	1
	bakje	explanation	1
	schenken	explanation	1
&xxxxojə	gooien	explanation	1
	jasje	explanation	1
	broek	explanation	1
ts	motorfiets	explanation	1
n	Evelien	explanation	1
kə	Frederike	explanation	2
	strijkijzer	explanation	1
&benə	wegbrengen	explanation	1
n	opstaan	explanation	3
	vogeltjes	explanation	1
siek	muziek	explanation	2
pier	papier	explanation	1
helpie	help	explanation	1
	varkentje	explanation	3
t	knort	explanation	1
	stukje	explanation	1
	meneer	explanation	4
	papier	explanation	1
mə	badkamer	explanation	2
gooien	weggooien	explanation	1
jə	weggooien	explanation	1
bak	vuilnisbak	explanation	1
	clown	explanation	1
	clowntje	explanation	1
	balkon	explanation	1
&fakjə	varkentje	explanation	1
maken	halen	explanation	1
	zand	explanation	1
beer	probeer	noncompletion	12
	fout	explanation	1
	verkeerd	explanation	1
	stop	explanation	1
maken	verven	explanation	1
	gaan	explanation	1
	lekker	explanation	1
&faxə	vragen	explanation	1
&nin	in	explanation	1
&xeixə	krijgen	explanation	1
	twee	explanation	1
&di	drie	explanation	1
	drie	explanation	1
n	groen	explanation	1
&bauw	blauw	explanation	1
mpjə	raampje	explanation	1
	toren	explanation	3
&do	toren	explanation	1
boel	heleboel	explanation	1
	help	explanation	1
	andersom	explanation	1
t	moet	explanation	1
	blauw	explanation	1
vangen	vouwen	explanation	3
kakas	vogels	explanation	1
	snel	explanation	1
xxx	name	explanation	1
	dacht	noncompletion	1
tjə	papiertje	explanation	2
	plakkertje	explanation	1
&hixə	liggen	explanation	1
	kukeleku	explanation	1
	past	explanation	1
&pas	past	explanation	1
	klemmetje	explanation	1
	omdraaien	explanation	1
	klem	explanation	1
Ie	Ieke	noncompletion	1
neden	beneden	noncompletion	22
hou	houden	noncompletion	1
hoon	telefoon	explanation	1
&kext	gekregen	explanation	2
bij	mij	explanation	1
	rijstebrij	explanation	1
	muesli	explanation	1
&kikəs	knikkers	explanation	1
t	groot	explanation	1
tels	bretels	noncompletion	2
bon	ballon	explanation	9
	water	explanation	1
	waterval	explanation	1
	klimrek	explanation	1
&he	hebben	explanation	3
&bot	kapot	explanation	2
&memən	nemen	explanation	2
	rijst	explanation	2
t	brood	explanation	2
nhauwə	aanhouden	explanation	1
	sla	explanation	2
&pamətjə	pannetje	explanation	1
	pan	explanation	1
tsa	pizza	explanation	1
t	gaatje	explanation	1
pus	puzzel	explanation	2
zakkie	rugzak	explanation	1
	staan	noncompletion	1
Han	Hannah	noncompletion	3
&tekt	uitgetrokken	explanation	1
&les	lezen	explanation	1
	grote	explanation	1
	niet	noncompletion	1
&ikəkə	Ieke	explanation	1
	zal	noncompletion	2
&ko	komt	explanation	1
&kookt	gekookt	explanation	1
	lieveheersbeestje	explanation	1
	klok	explanation	1
mər	studeerkamer	explanation	1
tjə	plaatje	explanation	6
t	plaatje	explanation	2
&but	moet	explanation	1
wtjə	verhaaltje	explanation	1
haaltje	verhaaltje	noncompletion	7
	vakantie	explanation	3
tə	bootje	explanation	1
	eens	noncompletion	1
&esow	is	explanation	1
ziekje	muziekje	noncompletion	1
əsapə	geslapen	explanation	1
&xunə	schoenen	explanation	1
tə	badje	explanation	1
tə	water	explanation	1
&bukə	boekje	explanation	1
&papapa	papa	explanation	1
	gespeeld	explanation	2
uittrekt	uitgetrokken	explanation	1
klein	kleine	noncompletion	4
&beibei	bij	explanation	1
heerbeestje	lieveheersbeestje	explanation	2
deerkamer	studeerkamer	explanation	1
	bezig	noncompletion	1
&budin	boerin	explanation	1
s	duplo	explanation	5
&s	schuiven	explanation	1
	was	noncompletion	1
əpak	gepakt	explanation	1
r	elkaar	explanation	2
ven	caravan	explanation	2
kən	takelen	explanation	3
rə	kopieren	explanation	1
	centimeter	explanation	1
&kesə	kletsen	explanation	1
&klesə	kletsen	explanation	1
	pleister	explanation	1
	gezegd	noncompletion	1
enəs	eendjes	explanation	1
kə	optakelen	explanation	1
j	draaien	explanation	1
kəkə	optakelen	explanation	1
kətəkə	takelen	explanation	1
&muwək	moeilijk	explanation	2
kəkə	takelen	explanation	5
&tekə	trekker	explanation	1
	televisie	explanation	2
kə	beddelaken	explanation	1
	neushoorn	explanation	1
&fondə	gevonden	explanation	1
	leggen	explanation	1
&kopijəm	koppetje	explanation	1
&dyəkətjə	duikelen	explanation	1
duiken	duikelen	explanation	2
&mulək	moeilijk	explanation	1
tax	zaterdag	explanation	1
gaan	gegaan	explanation	1
&bokə	blokken	explanation	1
	niet	explanation	1
	giraffe	explanation	4
jaf	giraffe	explanation	4
&kefe	caravan	explanation	2
	gelukt	explanation	1
si	vakantie	explanation	1
&xo	schoon	explanation	1
	heleboel	explanation	2
kof	koffie	noncompletion	4
	chocola	explanation	3
	chocolade	explanation	1
speeld	gespeeld	noncompletion	12
fasje	vaasje	explanation	1
t	spulletjes	explanation	1
ts	spulletjes	explanation	1
	omgevallen	explanation	1
t	water	explanation	1
opdrink	opdrinken	noncompletion	1
&tapə	stappen	explanation	3
&bo	boven	explanation	1
&dinkə	drinken	explanation	1
	klein	explanation	1
&herə	repareren	explanation	2
&fes	fles	explanation	1
kar	elkaar	replacement	1
iek	Ieke	explanation	1
t	grote	explanation	1
&vixətjə	vliegje	explanation	2
	caravan	explanation	1
&kein	kleine	explanation	1
&kimə	klimmen	explanation	1
&ketjə	karretje	explanation	1
	drukken	explanation	1
	giraffen	explanation	1
&ziraf	giraf	explanation	1
tjə	biscuitje	explanation	3
	kleertjes	explanation	1
&kexə	gekregen	explanation	2
sjə	garage	explanation	2
kaar	elkaar	explanation	1
naaid	genaaid	noncompletion	1
&rerə	repareren	explanation	1
	troep	explanation	1
kjəs	varkentjes	explanation	1
	dingetjes	explanation	2
&ef	even	explanation	1
in	naar	explanation	1
	con	noncompletion	1
	grasmaaimachine	explanation	1
&xrasmasjinə	grasmaaimachine	explanation	1
əpot	kapot	explanation	1
&lesət	lezen	explanation	1
&keikət	kijken	explanation	1
kjə	varkentje	explanation	2
&om	om	explanation	1
n	gedaan	explanation	1
kiep	kiepauto	noncompletion	1
	brandweerauto	explanation	1
&bauw	blauwe	explanation	1
&bauwə	blauwe	explanation	1
&bantauto	brandweerauto	explanation	1
n	misschien	explanation	3
de	het	explanation	2
&nade	nadenken	explanation	1
rafə	giraffe	explanation	1
&pyəmə	pruimen	explanation	1
	geit	explanation	1
sant	zand	explanation	2
	druifjes	explanation	1
	allemaal	explanation	1
&peikə	plukken	explanation	1
	krijgt	explanation	1
	heeft	explanation	1
	eieren	explanation	1
&eiə	eieren	explanation	1
	hondjes	explanation	1
vliegetje	vliegje	explanation	1
heersbeestje	lieveheersbeestje	noncompletion	2
wafwafe	honden	explanation	1
wafwafə	honden	explanation	1
	onder	explanation	1
&wondə	honden	explanation	1
&kefə	kever	explanation	1
t	staart	explanation	3
	vliegtuigen	explanation	1
&postəbodə	postbode	explanation	1
brandauto	brandweerauto	noncompletion	10
	scheppen	explanation	1
l	allemaal	explanation	1
it	gegooid	explanation	1
zine	benzine	noncompletion	20
	paddestoelen	explanation	1
	oven	noncompletion	1
pt	gekocht	explanation	1
r	kamerkoor	explanation	1
&wot	wordt	explanation	1
	thuis	explanation	1
kommer	komkommer	noncompletion	1
&nipə	knippen	explanation	1
graafchine	graafmachine	noncompletion	22
	Loekie	explanation	1
&juki	Loekie	explanation	1
	waren	noncompletion	1
	pas	noncompletion	1
&bibətek	bibliotheek	explanation	1
k	bibliotheek	explanation	2
kol	knol	explanation	1
tien	Christien	noncompletion	22
kiepen	omkiepen	noncompletion	1
reren	repareren	noncompletion	4
reerd	gerepareerd	noncompletion	2
&jejet	gerepareerd	explanation	2
vlieg	vliegt	noncompletion	1
takel	takelen	noncompletion	1
&solt	zolder	explanation	1
Thij	Thijs	noncompletion	1
&xabet	gerepareerd	explanation	1
timmer	timmeren	noncompletion	9
cies	precies	noncompletion	3
taarnpaal	lantaarnpaal	noncompletion	2
	kozijn	explanation	1
&pano	piano	explanation	1
koopt	gekocht	explanation	1
siering	versiering	noncompletion	2
ving	vingers	noncompletion	2
&lisəbet	Elisabeth	explanation	1
&sex	zeggen	explanation	1
eend	eendjes	noncompletion	1
sexe	zeggen	explanation	1
eend	eendje	noncompletion	1
&sex	zegt	explanation	1
s	deze	explanation	1
Sas	Saskia	noncompletion	2
stopt	gestopt	noncompletion	1
beer	boot	explanation	1
valt	gevallen	explanation	2
veeg	veger	explanation	1
rə	dirigeren	explanation	1
vark	varkens	noncompletion	1
rə	kamperen	explanation	1
pep	pepernoten	explanation	1
gevaard	gevaren	explanation	1
som	andersom	explanation	1
zit	is	explanation	1
f	even	explanation	2
	xxx	explanation	1
take	takelen	noncompletion	1
zoek	bezoek	noncompletion	1
pres	expres	noncompletion	1
	wordt	explanation	1
eie	eieren	noncompletion	3
əret	gerepareerd	replacement	1
jət	draait	explanation	1
botə	boten	explanation	1
&papot	kapot	explanation	4
	met	noncompletion	2
	zitten	noncompletion	1
kaar	elkaar	noncompletion	6
də	broden	explanation	1
zoek	gezocht	explanation	1
	floep	explanation	1
	ga	noncompletion	1
grote	groter	noncompletion	4
foto	fototoestel	noncompletion	1
rijn	mandarijn	noncompletion	2
noeg	genoeg	noncompletion	11
n	neushoorn	explanation	1
dil	krokodil	noncompletion	1
pareren	repareren	noncompletion	10
afhalet	afhalen	explanation	1
parkeerd	geparkeerd	noncompletion	4
&tupə	troepjes	explanation	1
gepoep	gepoept	noncompletion	1
kam	kwam	noncompletion	1
&nøshoəndə	neushoorns	explanation	1
gerijgd	geregen	explanation	1
	stoel	noncompletion	1
plast	geplast	noncompletion	1
meegenoomt	meegenomen	explanation	1
vuilnis	vuilnisauto	noncompletion	1
worden	geworden	noncompletion	3
&xəreiə	gereden	explanation	1
	leeg	noncompletion	1
ruimen	opruimen	explanation	1
chine	machine	noncompletion	1
bal	balkon	noncompletion	1
kon	balkon	noncompletion	1
maul	rozijn	explanation	1
laat	laatste	noncompletion	1
weggerijden	weggereden	explanation	1
pareerd	gerepareerd	noncompletion	7
wor	worden	noncompletion	1
boel	heleboel	noncompletion	3
	wil	noncompletion	1
&sjon	station	explanation	1
wacht	wachten	noncompletion	2
heeft	moet	explanation	1
hele	helemaal	noncompletion	4
dak	dakje	noncompletion	1
je	dakje	noncompletion	1
rə	logeren	explanation	1
	zou	noncompletion	1
	jou	noncompletion	1
zee	zeehond	noncompletion	1
voor	voorlezen	noncompletion	1
buit	buiten	noncompletion	6
gemaak	gemaakt	noncompletion	1
gepak	gepakt	noncompletion	2
telse	bretels	explanation	1
bretelse	bretels	explanation	1
heerbeestjes	lieveheersbeestjes	noncompletion	1
geword	geworden	noncompletion	6
weggesaxt	weggejaagd	explanation	1
kinder	kinderen	noncompletion	3
gooid	gegooid	noncompletion	4
motief	locomotief	noncompletion	1
nist	machinist	noncompletion	1
spinist	machinist	explanation	4
Boudew	Boudewijn	noncompletion	1
direc	directeur	noncompletion	1
conduc	conducteur	noncompletion	1
zak	zakt	noncompletion	1
zakt	gezakt	noncompletion	4
eien	eieren	explanation	1
van	bij	explanation	1
op	bij	explanation	1
&vi	wil	explanation	1
luiden	geluiden	noncompletion	1
&is	eens	explanation	1
heb	hebben	noncompletion	6
autoot	autootjes	noncompletion	1
geschuifd	geschoven	explanation	2
	moeten	noncompletion	2
	anders	noncompletion	2
	waar	noncompletion	4
gekoopt	gekocht	explanation	1
afgevald	afgevallen	explanation	1
leili	jullie	explanation	1
pauw	pistool	explanation	1
slagen	slaan	explanation	1
alsje	alsjeblieft	noncompletion	1
heb	ben	explanation	1
pop	apekop	explanation	1
Xet	gegeten	explanation	1
heef	heb	explanation	3
habben	happen	explanation	1
heven	hebben	explanation	3
monten	monden	explanation	1
gongen	gingen	explanation	1
bloemen	bosbessen	explanation	1
&xit	Geert	explanation	1
	Geert	explanation	1
	pakken	noncompletion	1
dees	deze	explanation	7
maultjes	rozijnen	explanation	2
trasje	matrasje	noncompletion	2
gevalt	gevallen	explanation	1
stalleren	installeren	noncompletion	1
meegenemen	meegenomen	explanation	1
kannen	kunnen	explanation	5
	mama	noncompletion	1
	moeder	noncompletion	1
	zijn	noncompletion	2
volgende	vorige	explanation	1
opgepompen	opgepompt	explanation	1
strokbrood	stokbrood	explanation	1
gebrengd	brengen	explanation	1
gebrengd	gebracht	explanation	1
klaartjes	kaartjes	explanation	1
boerde	boerderij	noncompletion	1
leuling	leuning	explanation	2
vertel	vertellen	noncompletion	1
bladden	bladen	explanation	2
langes	lange	explanation	4
vanoch	vanochtend	noncompletion	1
lopen	weglopen	noncompletion	1
glij	glijden	explanation	1
Jisk	Jiska	noncompletion	9
er	frisbee	explanation	1
Jis	Jiska	noncompletion	5
t	dat	noncompletion	31
hem	recorder	explanation	2
koet	koetjes	noncompletion	1
die	sticker	explanation	1
ha	had	noncompletion	2
tappen	stappen	noncompletion	5
Pet	Peter	noncompletion	17
sap	stappen	noncompletion	1
zij	dog	explanation	1
stap	stappen	noncompletion	7
	Jiska	explanation	2
	hoog	explanation	3
op	open	noncompletion	41
tap	stap	noncompletion	1
oef	woef	noncompletion	3
bov	boven	noncompletion	2
kok	koken	noncompletion	1
schille	schilletjes	noncompletion	1
ook	kook	noncompletion	1
tap	stappen	noncompletion	1
et	eten	noncompletion	3
kok	klok	noncompletion	12
ov	over	noncompletion	4
boon	boontjes	noncompletion	1
al	bal	noncompletion	1
boe	boem	noncompletion	1
het	box	explanation	1
daarz	daarzo	noncompletion	4
handte	handtekening	noncompletion	1
lam	lamp	noncompletion	1
jajaj	telefoon	explanation	2
bommer	brommer	noncompletion	1
vlieg	vliegtuig	noncompletion	2
pof	pantoffel	noncompletion	1
	liggen	explanation	2
lig	liggen	noncompletion	4
gezel	gezellig	noncompletion	1
naan	banaan	noncompletion	8
taf	tafel	noncompletion	1
aut	auto	noncompletion	7
dijn	gordijn	noncompletion	5
lep	lepel	noncompletion	2
Liga	cracker	explanation	1
Fabi	Fabian	noncompletion	1
ha	halen	noncompletion	11
daait	draait	noncompletion	1
kof	koffer	noncompletion	1
radi	radio	noncompletion	1
warming	verwarming	noncompletion	1
haa	haal	noncompletion	2
taan	staan	noncompletion	7
zuiger	stofzuiger	noncompletion	60
kij	kijken	noncompletion	7
&fysə	lucifers	explanation	1
zi	zitten	noncompletion	2
telefo	telefoon	noncompletion	1
spe	spelen	noncompletion	2
kusj	kusje	noncompletion	1
Tine	Tineke	noncompletion	1
ma	maken	noncompletion	5
manne	mannetje	noncompletion	8
ongelu	ongeluk	noncompletion	1
vuilniswa	vuilniswagen	noncompletion	1
vuilbak	vuilnisbak	noncompletion	1
meezing	meezingen	noncompletion	1
ev	even	noncompletion	18
kind	kindjes	noncompletion	1
zuig	stofzuiger	noncompletion	2
zuige	stofzuigen	noncompletion	1
zing	zingen	noncompletion	1
doeling	bedoeling	noncompletion	1
telef	telefoon	noncompletion	1
zien	gezien	noncompletion	6
foon	telefoon	noncompletion	1
koptele	koptelefoon	noncompletion	1
schonen	verschonen	noncompletion	1
potje	poppetje	noncompletion	9
opzet	opgezet	noncompletion	2
magtron	magnetron	noncompletion	1
knoeid	geknoeid	noncompletion	2
zuig	stofzuig	noncompletion	1
kas	kassa	noncompletion	1
tracto	tractor	noncompletion	1
voetba	voetballen	noncompletion	1
opbeur	opbeuren	noncompletion	2
dalijk	dadelijk	noncompletion	75
kin	kindjes	noncompletion	1
suk	stuk	noncompletion	1
zelf	vanzelf	noncompletion	4
ruimen	opruimen	noncompletion	2
geb	gebeurd	noncompletion	1
eves	eventjes	noncompletion	1
kop	koptelefoon	noncompletion	1
gage	garage	noncompletion	2
rol	rollen	noncompletion	1
afelopen	afgelopen	noncompletion	1
val	vallen	noncompletion	2
drink	drinkt	noncompletion	1
waa	waar	noncompletion	11
n	in	noncompletion	1
poppe	poppetje	noncompletion	2
blauw	blauwe	noncompletion	1
rammel	rammelt	noncompletion	1
omval	omvallen	noncompletion	1
erijd	gerijd	noncompletion	1
va	vast	noncompletion	1
bils	billetjes	noncompletion	1
hardlop	hardlopen	noncompletion	1
botje	bolletje	noncompletion	1
boltje	bolletje	noncompletion	2
kik	kikker	noncompletion	2
voetj	voetje	noncompletion	1
een	eend	noncompletion	2
iem	iemand	noncompletion	2
ving	vinger	noncompletion	4
wil	wild	noncompletion	1
blijf	blijft	noncompletion	1
weerauto	brandweerauto	noncompletion	1
s	als	noncompletion	14
beta	betalen	noncompletion	29
thui	thuis	noncompletion	1
va	vallen	noncompletion	3
vinger	vingers	noncompletion	1
ta	betalen	noncompletion	1
cen	cent	noncompletion	1
rij	rijden	noncompletion	2
d	dit	noncompletion	3
wasmachi	wasmachine	noncompletion	1
betaal	betaald	noncompletion	1
draaimo	draaimolen	noncompletion	2
brandweerau	brandweerauto	noncompletion	1
on	onder	noncompletion	2
hal	halen	noncompletion	2
Diene	Dieneke	noncompletion	1
coordina	coordinatie	noncompletion	1
mak	maken	noncompletion	3
nuutje	minuutje	noncompletion	1
acht	achter	noncompletion	1
erach	erachter	noncompletion	1
vuilniswag	vuilniswagen	noncompletion	1
kraanwa	kraanwagen	noncompletion	1
var	varken	noncompletion	1
spring	springen	noncompletion	1
blijv	blijven	noncompletion	1
tuuk	natuurlijk	noncompletion	1
	mag	explanation	1
dru	drukken	noncompletion	1
&fakto	tractor	explanation	1
ven	even	noncompletion	2
er	eruit	noncompletion	1
gebeur	gebeurd	noncompletion	1
uitkip	uitknip	noncompletion	1
uitkippen	uitknippen	noncompletion	1
mzelf	hemzelf	noncompletion	1
kabout	kabouter	noncompletion	2
ko	komen	noncompletion	1
voorui	vooruit	noncompletion	1
meka	mekaar	noncompletion	1
niemand	iemand	explanation	1
brandweeraut	brandweerauto	noncompletion	1
branen	branden	noncompletion	1
bouter	kabouter	noncompletion	5
geworen	geworden	noncompletion	1
laa	laat	noncompletion	7
daj	daar	explanation	1
tit	dit	explanation	1
tees	deze	explanation	2
ta	daar	explanation	2
keg	weg	explanation	1
Kraka	Carla	explanation	1
waag	wagen	explanation	1
but	bus	explanation	1
graggage	vrachtwagen	explanation	1
Kaka	Carla	explanation	3
opak	oppas	explanation	1
hing	ring	explanation	1
oom	open	explanation	1
paar	paard	explanation	1
paa	paard	explanation	1
gank	vrachtwagen	explanation	1
kok	kop	explanation	1
bau	blauw	explanation	1
tauw	blauw	explanation	1
gaga	vrachtwagen	explanation	7
ete	eten	explanation	4
keuke	koken	explanation	2
bandte	band	explanation	1
koeke	keuken	explanation	1
dieen	knieen	explanation	1
ebij	erbij	noncompletion	1
heen	speen	explanation	1
gagaag	vrachtwagen	explanation	1
paadje	paardje	explanation	2
bag	bad	explanation	1
dui	trui	explanation	1
hoen	schoen	explanation	1
diktak	tiktak	explanation	1
goen	groen	explanation	2
inne	in	explanation	1
disse	deze	explanation	1
ijke	kijken	explanation	1
bov	boven	explanation	1
boeve	boven	explanation	1
tikker	trekker	explanation	10
buset	bus	explanation	1
zeka	zebra	explanation	1
foon	telefoon	explanation	1
king	ring	explanation	3
ting	ring	explanation	2
koekoos	koekjes	explanation	1
ap	sap	explanation	1
hijs	Gijs	explanation	1
beuite	buiten	explanation	1
beena	been	explanation	2
tiek	muziek	explanation	2
boppa	boven	explanation	1
boet	voet	explanation	1
buite	buiten	explanation	3
uier	luier	explanation	1
tiets	fiets	explanation	1
koon	schoon	explanation	1
kla	klaar	explanation	1
tentum	tent	explanation	1
agge	vrachtwagen	explanation	1
aga	vrachtwagen	explanation	2
tekker	trekker	explanation	12
neel	geel	explanation	1
agga	vrachtwagen	explanation	1
koeen	koeien	explanation	1
kieker	gieter	explanation	1
ies	iets	explanation	1
roogk	rook	explanation	1
teeuwt	sneeuwt	explanation	1
hagel	hagelslag	explanation	2
titten	zitten	explanation	3
horst	worst	explanation	1
tomme	stom	explanation	2
host	worst	explanation	3
chool	school	explanation	2
fiest	fiets	explanation	2
ooi	hooi	explanation	1
hooiwage	hooiwagen	explanation	1
fietsepomp	fietspomp	explanation	1
ooie	rooie	explanation	2
gooie	rooie	explanation	1
goon	schoon	explanation	1
bangeweer	brandweer	explanation	1
mimi	mini	explanation	1
busebus	bus	explanation	1
hein	konijn	explanation	1
veven	verven	explanation	3
choonmaken	schoonmaken	explanation	1
pauze	proosten	explanation	1
eendə	eenden	explanation	1
zaan	zwaan	explanation	1
choon	schoon	explanation	1
pas	pats	explanation	1
kinne	kinderen	explanation	2
kaaie	kraaien	explanation	1
Hike	Hiske	explanation	2
zankbak	zandbak	explanation	1
pas	plas	explanation	3
lese	lezen	explanation	1
volle	vallen	explanation	1
saap	slapen	explanation	2
pee	speen	explanation	1
henne	rennen	explanation	1
paaf	tafel	explanation	1
hekop	helikopter	explanation	1
sape	slapen	explanation	1
hoete	hoed	explanation	1
choene	schoenen	explanation	1
sitte	zitten	explanation	1
hijen	rijden	explanation	1
tug	terug	explanation	1
boetje	boertje	explanation	1
tom	stom	explanation	1
dommes	jongens	explanation	1
cooy	cowboy	explanation	1
hijt	rijdt	explanation	2
pasla	plassen	explanation	1
dokie	cadeautje	explanation	2
tui	trui	explanation	1
pagen	plagen	explanation	1
boerij	boerderij	explanation	1
poberen	proberen	explanation	2
piegel	priegel	explanation	1
anner	ander	explanation	1
paaden	paarden	explanation	1
gond	grond	explanation	1
voorbee	voorbeeld	explanation	1
ijk	kijk	explanation	1
ijn	konijn	explanation	1
muize	muizen	explanation	1
wokke	wolken	explanation	1
hemaal	helemaal	explanation	1
laazen	laarzen	explanation	4
papelu	paraplu	explanation	1
kuiwagen	kruiwagen	explanation	1
bane	zwanen	explanation	1
onnem	onder	explanation	1
rije	rijden	explanation	5
ennen	rennen	explanation	1
tapen	slapen	explanation	1
janbak	zandbak	explanation	1
kaan	kraan	explanation	4
hon	hond	explanation	1
tanjaboom	kastanjeboom	explanation	2
choo	schommel	explanation	1
waat	water	explanation	3
hij	rij	explanation	1
toeken	zoeken	explanation	3
poko	vogel	explanation	1
choenen	schoenen	explanation	6
klitte	kleren	explanation	1
kikken	knikkers	explanation	1
kikkens	knikkers	explanation	1
mole	molen	explanation	1
mool	molen	explanation	1
moode	molen	explanation	1
vachauto	vrachtauto	explanation	3
mu	muur	explanation	1
vachtauto	vrachtauto	explanation	4
niet	niet	explanation	4
gagie	garage	explanation	1
vachtauto	vrachtauto	noncompletion	2
bije	bij	explanation	1
kwij	kwijt	explanation	1
aanwawagen	aanhangwagen	explanation	1
aawagen	aanhangwagen	explanation	1
vagge	varken	explanation	1
mantie	mandje	explanation	1
nijnties	konijnen	explanation	1
patasol	parasol	explanation	1
patesol	parasol	explanation	2
kekker	kikker	explanation	2
heeuwroppen	sneeuwpoppen	explanation	1
wannele	wandelen	explanation	1
elekopter	helikopter	explanation	1
nik	niks	explanation	1
mui	muis	explanation	1
staat	staart	explanation	1
buman	buurman	explanation	1
richat	Richard	explanation	1
manarijntie	mandarijntje	explanation	1
kegen	gekregen	explanation	3
buuman	buurman	explanation	3
oop	opa	explanation	1
hegen	gekregen	explanation	1
tijg	tijger	explanation	1
Calaline	Caroline	explanation	2
vev	verf	explanation	11
papiet	papier	explanation	1
Momas	Tomas	explanation	15
kras	kwast	explanation	1
tenne	antenne	explanation	1
poties	potjes	explanation	1
pietie	papiertje	explanation	1
tijgen	tijger	explanation	2
loemetie	bloemetje	explanation	1
hijbaan	glijbaan	explanation	1
lodder	klodder	explanation	1
on	onder	explanation	2
tatiebo	consultatiebureau	explanation	1
plakkətie	plakkertje	explanation	1
stom	stormt	explanation	1
bod	bord	explanation	1
autotie	autootje	explanation	1
tikker	kikker	explanation	1
rote	grote	explanation	1
hijkraan	hijskraan	explanation	3
ego	lego	explanation	1
peelgoed	speelgoed	explanation	2
cocolade	chocolade	explanation	1
deurtie	deurtje	explanation	1
vachaut	vrachtauto	explanation	1
viel	wiel	explanation	1
giga	giraffe	explanation	1
ton	zon	explanation	1
blauw	blauwe	explanation	1
winties	windjes	explanation	1
tiezen	kiezen	explanation	1
vevies	precies	explanation	1
pliesie	politie	explanation	1
solelatie	chocolaatje	explanation	2
conelatie	chocolaatje	explanation	3
oli	olifant	explanation	1
nurf	slurf	explanation	2
lang	langs	explanation	1
zandbad	zandbak	explanation	1
chuur	schuur	explanation	1
regen	regenen	explanation	1
palaplu	paraplu	explanation	8
pin	spin	explanation	2
toppen	verstoppen	explanation	1
krijkraan	hijskraan	explanation	1
huisies	huisjes	explanation	1
een	eend	explanation	1
manen	zwanen	explanation	1
panen	zwanen	explanation	1
onne	onder	explanation	2
ploemen	bloemen	explanation	1
televies	televisie	explanation	1
honties	hondjes	explanation	1
nijnen	konijn	explanation	1
konijnie	konijntje	explanation	1
Nietak	Wieger	explanation	1
choppen	schoppen	explanation	1
Klien	Caroline	explanation	1
ok	hok	explanation	1
kapeel	kameel	explanation	1
trapə	trap	explanation	1
kinstoel	kinderstoel	explanation	1
eenties	eendjes	explanation	4
na	naar	explanation	3
bui	buiten	explanation	1
kindeties	kindertjes	explanation	1
muisies	muisjes	explanation	1
vedə	verder	explanation	1
chaapies	schaapjes	explanation	1
koen	kalkoen	explanation	1
Carodieme	Caroline	explanation	1
napel	appel	explanation	1
Omas	Tomas	explanation	1
kakantie	vakantie	explanation	1
vemmen	zwemmen	explanation	1
antele	wandelen	explanation	1
uitpugen	spugen	explanation	1
ker	lekker	explanation	1
weg	snelweg	explanation	1
grift	schrift	explanation	1
duive	duiven	explanation	1
platies	plasjes	explanation	1
hoon	honing	explanation	1
sappesap	appelsap	explanation	1
piplo	duplo	explanation	1
gasie	garage	explanation	2
garasie	garage	explanation	2
gamage	garage	explanation	1
bjanden	banden	explanation	1
viegtuig	vliegtuig	explanation	1
neememen	meenemen	explanation	1
sep	schep	explanation	1
pullen	spullen	explanation	3
bempadje	zwembadje	explanation	1
bin	binnen	explanation	1
pieplo	duplo	explanation	1
toppen	stoppen	noncompletion	1
oppas	oppasser	explanation	1
hootsteen	gootsteen	explanation	1
vals	wals	explanation	1
wijs	eigenwijs	explanation	1
andern	andere	explanation	1
badie	bakje	explanation	1
vaar	zwaar	explanation	1
kakon	balkon	explanation	2
chaar	schaar	explanation	1
Gij	Gijs	explanation	1
eet	gegeten	explanation	1
geligt	ligt	explanation	1
tiekhuis	ziekenhuis	explanation	1
bloe	bloed	explanation	1
doppie	dopje	explanation	1
toelpoot	stoelpoot	explanation	1
Gronengen	Groningen	explanation	1
traks	straks	explanation	2
pupelo	duplo	explanation	2
krinken	drinken	explanation	1
drink	verdrink	explanation	1
bovenrop	bovenop	explanation	1
boverop	bovenop	explanation	1
vinne	winnen	explanation	1
juier	luier	explanation	2
goevedraaier	schroevedraaier	explanation	1
Jannie	Jan	explanation	1
bodje	bordje	explanation	1
trijplank	strijkplank	explanation	1
koppetrein	kapitein	explanation	1
kapetrein	kapitein	explanation	1
chommel	schommel	explanation	2
buize	buis	explanation	1
lang	slang	explanation	1
bater	water	explanation	1
al	allemaal	explanation	1
snikkers	knikkers	explanation	1
tonde	rotonde	explanation	1
tankesjon	tankstation	explanation	1
taat	gaat	explanation	1
aut	auto	explanation	2
vedoor	vandoor	explanation	1
loketief	locomotief	explanation	1
peg	weg	explanation	3
vank	gevangen	explanation	1
cheppe	scheppen	explanation	1
klingers	slingers	explanation	1
druppetje	druppeltje	explanation	1
plu	paraplu	explanation	1
eehoorn	eekhoorn	explanation	1
saapzak	slaapzak	explanation	2
vote	grote	explanation	1
də	er	explanation	1
meemt	neemt	explanation	1
as	als	explanation	2
duuk	stuk	explanation	1
chep	schep	explanation	2
mot	modder	explanation	1
meerspoe	smeerpoets	explanation	1
bote	boten	noncompletion	10
ban	banaan	noncompletion	2
pannekoeke	pannekoeken	noncompletion	6
wijn	zwijn	noncompletion	2
wemme	zwemmen	noncompletion	2
to	toren	noncompletion	1
antoot	auto	replacement	1
autoot	auto	replacement	7
blokke	blokken	noncompletion	6
baj	bal	replacement	11
Die	Diederik	noncompletion	48
amband	armband	noncompletion	2
opeblaze	opgeblazen	noncompletion	1
we	weg	noncompletion	7
paade	paardje	noncompletion	2
paaje	paardje	noncompletion	1
kein	klein	noncompletion	21
tuis	thuis	noncompletion	1
pie	papieren	replacement	1
dam	madam	noncompletion	52
tepot	kapot	replacement	2
Min	Maria	replacement	6
schijve	schrijven	noncompletion	2
heppe	helpen	replacement	1
Diek	Diederik	noncompletion	8
toen	stoel	replacement	7
lape	slapen	noncompletion	6
bokke	blokken	noncompletion	9
vane	vallen	replacement	1
vaa	vaar	noncompletion	2
tug	terug	noncompletion	3
wiets	fiets	replacement	4
taten	soldaten	replacement	1
oene	schoenen	noncompletion	1
tinneke	kindeke	replacement	1
kineke	kindeke	noncompletion	9
boe	boek	noncompletion	2
kee	gekregen	replacement	1
tam	madam	replacement	46
Diede	Diederik	noncompletion	40
piepe	piep	replacement	1
ketellen	vertellen	replacement	1
tellen	vertellen	replacement	1
telle	vertellen	replacement	2
tommel	trommel	noncompletion	2
tomme	trommel	noncompletion	1
epot	kapot	replacement	1
neeje	nee	replacement	1
toel	stoel	replacement	1
boj	buik	replacement	1
Anold	Arnold	noncompletion	5
hijve	schrijven	noncompletion	3
hijven	schrijven	noncompletion	1
bon	ballon	replacement	1
poen	kapoen	noncompletion	1
wepe	werpen	noncompletion	1
Arno	Arnold	noncompletion	1
vinge	vinger	noncompletion	2
Anne	Arnold	replacement	2
poese	poesje	noncompletion	3
schijf	schrijf	noncompletion	1
onne	onder	replacement	3
sijve	schrijven	noncompletion	4
bo	bol	noncompletion	1
ote	grote	noncompletion	9
voge	vogel	noncompletion	9
ewees	geweest	noncompletion	4
menee	meneer	noncompletion	1
lekke	lekkere	noncompletion	1
paademolen	paardemolen	noncompletion	7
vaje	vallen	replacement	1
toje	toren	replacement	1
pinge	springen	noncompletion	4
emme	emmer	noncompletion	3
vinne	vlinder	replacement	1
hepe	helpen	noncompletion	5
oppe	op	replacement	4
bee	beer	noncompletion	25
afbijve	afblijven	noncompletion	1
ne	een	replacement	16
Anod	Arnold	noncompletion	36
too	toren	replacement	2
Diejik	Diederik	replacement	7
hepen	helpen	noncompletion	1
An	Arnold	replacement	5
oprape	oprapen	noncompletion	4
paddemolen	paardemolen	replacement	1
sijven	schrijven	noncompletion	1
tooke	torentje	replacement	1
poejing	pudding	replacement	1
hijaf	giraf	replacement	2
bommel	brommer	replacement	1
eende	eenden	noncompletion	2
aape	aap	replacement	2
ijaf	giraf	replacement	1
opaap	opraap	noncompletion	1
wijntje	zwijntje	noncompletion	5
tappe	stappen	noncompletion	3
wate	zwarte	noncompletion	2
ommedaaje	omdraaien	replacement	1
bug	brug	noncompletion	1
vanne	vallen	replacement	3
Anond	Arnold	replacement	6
kesboom	kerstboom	noncompletion	1
taan	gedaan	replacement	1
onderdekke	onderdekken	noncompletion	2
wof	wolf	noncompletion	8
evan	gevallen	replacement	1
wande	wandelen	noncompletion	1
gevanne	gevallen	replacement	2
waake	wagen	replacement	1
wepje	werpen	replacement	1
mijten	smijten	noncompletion	1
ophange	ophangen	noncompletion	1
invalle	invallen	noncompletion	1
vajt	valt	replacement	3
vant	valt	replacement	8
bulte	bulten	noncompletion	4
ikke	ik	replacement	14
pele	spelen	noncompletion	24
sef	seffens	noncompletion	4
poppekas	poppenkast	noncompletion	1
pisse	pissen	noncompletion	2
wafe	wafel	noncompletion	1
opedoen	opendoen	noncompletion	6
Diedik	Diederik	noncompletion	81
scheppe	scheppen	noncompletion	1
inzette	inzetten	noncompletion	3
vok	vork	noncompletion	1
wa	waar	noncompletion	46
bleve	gebleven	noncompletion	3
borde	bordje	noncompletion	1
honde	hondje	noncompletion	3
appesien	appelsien	noncompletion	3
truch	terug	replacement	6
poplepel	pollepel	replacement	1
zwatte	zwarte	replacement	1
keef	kever	replacement	1
eet	eten	replacement	1
messeke	mesje	explanation	1
beeteke	beetje	replacement	2
naat	gaat	replacement	15
dekke	deksel	replacement	9
Died	Diederik	noncompletion	1
messekes	mesjes	replacement	1
eit	ei	replacement	1
eiteke	eitje	replacement	1
dekkes	deksel	replacement	2
eite	eitje	noncompletion	3
opedoe	opendoen	noncompletion	1
kablon	ballon	replacement	6
ji	is	replacement	1
anasse	ananas	replacement	1
appe	kappen	noncompletion	1
ablon	ballon	replacement	2
boterhamme	boterhammen	noncompletion	1
anddoek	handdoek	noncompletion	1
afdoge	afdrogen	noncompletion	1
afgedoot	afgedroogd	replacement	1
dieretuin	dierentuin	noncompletion	8
dees	dit	replacement	7
pepkoek	peperkoek	noncompletion	1
vokke	vork	replacement	4
bablon	ballon	replacement	1
dake	daken	noncompletion	1
somspaan	schuimspaan	replacement	1
ingedoet	ingedaan	replacement	1
affedoot	afgedroogd	replacement	1
vok	vork	replacement	2
omkappe	omkappen	noncompletion	7
annas	ananas	noncompletion	2
ene	een	replacement	2
pattetoel	paddestoel	replacement	1
pokeepel	pollepel	replacement	1
seppen	scheppen	noncompletion	1
bone	bruine	replacement	1
sooke	suiker	replacement	1
onde	hondje	noncompletion	3
beete	beetje	noncompletion	1
tuch	terug	replacement	5
opsteke	opsteken	noncompletion	1
insteke	insteken	noncompletion	11
goot	groot	noncompletion	2
eekhootje	eekhoorntje	noncompletion	1
dietjes	diertjes	noncompletion	2
pepekoek	peperkoek	noncompletion	1
rijspap	rijstpap	noncompletion	1
kant	kan	replacement	1
daat	draait	noncompletion	1
viegtoog	vliegtuig	replacement	3
afdoje	afdrogen	replacement	1
viegtoo	vliegtuig	replacement	1
zeke	zeker	noncompletion	3
onto	auto	replacement	12
opzet	opzetten	noncompletion	1
edoet	gedaan	replacement	1
naate	gaat	replacement	3
affedoen	afdoen	replacement	1
poezze	puzzel	replacement	1
innezette	inzetten	replacement	2
vliegtoog	vliegtuig	replacement	1
wietjes	wieltjes	noncompletion	1
glote	grote	replacement	1
kemis	kermis	noncompletion	1
vlagge	vlaggen	noncompletion	1
waan	zwaan	noncompletion	2
e	we	noncompletion	2
rijde	rijden	noncompletion	10
nate	gaat	replacement	1
vrachtwa	vrachtwagen	noncompletion	1
onde	onder	noncompletion	4
taat	staat	noncompletion	2
fabik	fabriek	noncompletion	1
aanmake	aanmaken	noncompletion	1
eef	heb	replacement	2
opsijve	opschrijven	noncompletion	1
viegtuig	vliegtuig	noncompletion	1
lat	ladder	replacement	1
vieg	vlieg	noncompletion	1
oot	uit	replacement	1
seffe	seffens	noncompletion	1
afdooje	afdrogen	replacement	1
pademolen	paardemolen	noncompletion	1
rijje	rijden	replacement	23
noes	neus	replacement	3
male	malen	noncompletion	1
kijge	krijgen	noncompletion	1
stoen	stoel	replacement	1
eeze	gelezen	replacement	2
wavis	walvis	noncompletion	1
roes	reus	replacement	2
daak	draak	noncompletion	1
papet	raket	replacement	1
oke	ook	replacement	2
instappe	instappen	noncompletion	1
geene	geen	replacement	1
wedaan	weggedaan	replacement	1
toessen	tussen	replacement	1
vloegel	vleugel	replacement	1
vlietui	vliegtuig	noncompletion	1
afpakke	afpakken	noncompletion	5
uitgedoet	uitgedaan	replacement	1
tok	stok	noncompletion	1
hame	hamer	noncompletion	3
joote	grote	replacement	1
toute	stoute	noncompletion	5
vie	vier	noncompletion	2
soon	schoon	noncompletion	2
boteham	boterham	noncompletion	1
eente	eendje	replacement	4
hoot	groot	replacement	1
moogt	mag	replacement	1
sepe	scherpe	noncompletion	2
tietui	dierentuin	replacement	2
dietoo	dierentuin	replacement	3
moog	mag	replacement	2
nen	een	replacement	1
diejetoon	dierentuin	replacement	1
tein	trein	noncompletion	33
tinke	drinken	replacement	1
most	morst	noncompletion	1
wegkuipe	wegkruipen	noncompletion	1
kokkedil	krokodil	replacement	3
krabbe	krabben	noncompletion	1
krabbe	krab	replacement	1
d'r	er	replacement	629
d'rnaast	ernaast	replacement	6
d'r	haar	replacement	80
waar	weer	replacement	1
vlietuig	vliegtuig	noncompletion	1
d'rin	erin	replacement	109
d'rbij	erbij	replacement	64
krabbers	krabben	replacement	1
d'raf	eraf	replacement	61
d'rop	erop	replacement	82
d'roverheen	eroverheen	replacement	3
d'rmee	ermee	replacement	13
rooie	rode	replacement	14
ikkes	ik	replacement	1
zit	er	replacement	1
prat	praten	noncompletion	1
gaat	ga	replacement	10
d'rvan	ervan	replacement	10
ter	er	replacement	3
gezingd	gezongen	replacement	1
zit	zitten	replacement	1
d'ruit	eruit	replacement	106
dat	omdat	noncompletion	16
goeie	goede	replacement	16
zatten	zaten	replacement	1
mij	ik	replacement	1
wegging	weggingen	replacement	1
d'rvoor	ervoor	replacement	2
jawe	jawel	noncompletion	1
nah	nou	replacement	3
d'raan	eraan	replacement	47
ziet	zie	replacement	1
grote	groot	replacement	1
ineens	eens	replacement	1
gewor	geworden	noncompletion	1
mekaar	elkaar	replacement	11
Maik	Maike	noncompletion	2
gevezicht	gezicht	replacement	1
keuteltje	kleutertje	replacement	1
plak	geplakt	replacement	1
liefies	liefjes	replacement	1
t'r	er	replacement	4
nieks	niks	replacement	1
heb	hebben	replacement	1
vasthouwe	vasthouden	replacement	3
dee	deze	replacement	6
toune	stoute	replacement	1
po	post	noncompletion	1
hijje	rijden	replacement	1
bante	band	replacement	1
Errenst	Ernst	replacement	3
dan	dank	noncompletion	1
d'rover	erover	replacement	6
b	bij	noncompletion	1
uitscheien	uitscheiden	noncompletion	1
heelmaal	helemaal	replacement	22
wrom	waarom	noncompletion	25
waren	was	replacement	1
deez	deze	replacement	48
asjeblieft	alsjeblieft	noncompletion	6
nimonade	limonade	replacement	1
aardbeie	aardbeien	noncompletion	1
leukie	leukerd	replacement	1
eest	eet	replacement	1
na	nou	replacement	3
d'ronder	eronder	replacement	5
Alexandera	Alexandra	replacement	1
tactor	tractor	noncompletion	9
Mai	Maike	noncompletion	1
mapa	papa	replacement	1
goen	schoen	replacement	1
d'rom	erom	replacement	2
voor	van	replacement	1
tietuig	vliegtuig	replacement	1
hui	huis	noncompletion	4
d'rtussendoor	ertussendoor	replacement	1
d'rdoorheen	erdoorheen	replacement	1
poeven	proeven	noncompletion	1
stir	ster	replacement	3
allem	allemaal	noncompletion	2
rije	rijden	replacement	2
schoenpoets	schoenpoetsen	noncompletion	1
lichtje	lichtjes	noncompletion	1
ouwe	oude	replacement	2
liefie	liefje	replacement	2
glijjen	glijden	replacement	2
is	zijn	replacement	1
schaa	schaatsen	noncompletion	1
moet	moeten	replacement	1
kan	ken	replacement	1
hrheen	hierheen	noncompletion	2
bekeken	bekijken	replacement	2
t'rop	erop	replacement	1
kleten	kleden	replacement	1
poepie	poepje	replacement	1
plassetje	plasje	replacement	1
zoe	zoeken	noncompletion	1
peuterspeel	peuterspeelzaal	noncompletion	1
ben	bent	replacement	3
ans	anders	replacement	6
uitgetrekt	uitgetrokken	replacement	1
kouwe	koude	replacement	9
met	moet	noncompletion	1
jewel	jawel	replacement	2
ellef	elf	replacement	3
Anie	Annie	replacement	1
viers	vieren	replacement	1
mekeer	elkaar	replacement	1
fiet	fiets	noncompletion	1
'b	hebt	replacement	1
tan	dan	replacement	4
ijssie	ijsje	replacement	6
strante	tante	replacement	1
bakkie	bakje	replacement	3
heelboel	heleboel	replacement	1
schroevies	schroefjes	replacement	1
peddel	peddels	noncompletion	1
bettie	bedje	replacement	1
vorkies	vorkjes	replacement	1
houwen	houden	replacement	7
teintje	treintje	noncompletion	2
ranten	randen	replacement	1
rande	randen	noncompletion	1
tout	stout	noncompletion	25
jijje	rijden	replacement	15
kaar	klaar	noncompletion	5
jijjen	rijden	replacement	3
stijgen	dalen	replacement	1
snoepie	snoepje	replacement	1
soepie	snoepje	replacement	1
droppies	dropjes	replacement	2
gebuiken	gebruiken	noncompletion	3
anne	andere	replacement	1
dopje	dropje	noncompletion	2
ebuiken	gebruiken	noncompletion	1
vnavond	vanavond	noncompletion	2
schrijv	schrijven	noncompletion	1
verstop	verstopt	noncompletion	1
seutel	sleutel	noncompletion	1
d'rheen	erheen	replacement	1
bauwe	blauwe	noncompletion	1
tee	twee	noncompletion	23
dieze	deze	replacement	2
s	anders	noncompletion	2
uitschie	uitschieten	noncompletion	1
geweet	geweten	replacement	1
hou	houd	noncompletion	9
end	eind	noncompletion	3
morgen	vanmorgen	replacement	1
zebben	hebben	replacement	1
ans	anders	noncompletion	3
koekjen	koekje	replacement	1
hie	wie	replacement	1
drogers	droogbloemen	replacement	1
mooien	mooie	replacement	1
zij	zijde	noncompletion	1
dat	mutsje	explanation	1
d'romheen	eromheen	replacement	4
d'rboven	erboven	replacement	2
koppie	kopje	replacement	3
doen	voordoen	noncompletion	1
roltrep	roltrap	replacement	1
wieletjes	wieltjes	replacement	1
hem	haar	replacement	1
d'rnaar	ernaar	replacement	4
allemal	allemaal	noncompletion	1
rechte	recht	replacement	1
d'rtussen	ertussen	replacement	2
kelwagens	takelwagens	noncompletion	1
hem	koptelefoon	explanation	1
waar	was	replacement	1
glee	gleed	noncompletion	19
broekie	broekje	replacement	1
makkie	makkelijk	replacement	1
maklijk	makkelijk	noncompletion	2
effe	even	replacement	53
kaik	kijk	replacement	1
volgende	vorige	replacement	1
gebroeden	gebroed	replacement	1
wegrijje	wegrijden	replacement	1
op	af	replacement	1
deze	autosleutel	explanation	1
d'rin	eruit	replacement	1
snijje	snijden	replacement	2
had	gehad	noncompletion	3
houwe	houden	replacement	5
onthouwen	onthouden	replacement	1
onthoude	onthouden	noncompletion	1
onthouwe	onthouden	replacement	1
zussie	zusje	replacement	1
erge	erg	replacement	1
ditte	dit	replacement	5
de	het	replacement	1
vliegmachien	vliegmachine	replacement	1
glijje	glijden	replacement	2
deze	dit	replacement	1
grappie	grapje	replacement	1
waartschuwt	waarschuwt	replacement	1
gehelpt	geholpen	replacement	1
hengeltje	hangertje	replacement	1
liendje	liedje	replacement	3
te	toe	replacement	1
om	omdat	noncompletion	4
chaffeurs	chauffeurs	noncompletion	1
ekkele	elke	replacement	1
kunip	knip	replacement	1
neememen	meenemen	replacement	1
t	want	noncompletion	4
beesj	besjes	replacement	1
kgkregen	gekregen	replacement	1
wilt	wilde	replacement	1
rooi	rood	replacement	1
eef	even	replacement	4
lullie	jullie	replacement	25
beeb	baby	replacement	4
ke	ikke	noncompletion	2
boks	bots	replacement	1
knuf	knuffel	noncompletion	2
vanaafst	vanavond	replacement	1
beneje	beneden	replacement	4
heel	helemaal	replacement	2
San	Sanne	noncompletion	3
broor	boor	replacement	1
enne	en	replacement	1
n	nu	noncompletion	1
jonkje	jongetje	replacement	1
vetetellen	vertellen	replacement	1
sterreltjes	sterretjes	replacement	1
stap	stapel	noncompletion	1
voorgende	volgende	replacement	1
stiekje	elastiekje	noncompletion	17
boekies	boekjes	replacement	1
stil	snel	replacement	1
pschems	beschermers	replacement	1
rom	waarom	noncompletion	2
groen	groene	noncompletion	1
woor	hoor	replacement	1
chrijven	schrijven	noncompletion	1
anne	ander	replacement	7
eel	geel	noncompletion	1
boewerij	boerderij	replacement	1
hema	helemaal	noncompletion	1
staarden	staarten	replacement	1
haaltjes	verhaaltjes	noncompletion	1
wannee	wanneer	noncompletion	1
micorder	recorder	replacement	5
meeme	nemen	replacement	1
jongte	jongste	noncompletion	1
knimmen	knippen	replacement	1
moziek	muziek	replacement	1
blaad	bladzijde	replacement	1
hedde	hebben	replacement	1
gullie	jullie	replacement	1
hebft	heeft	replacement	1
kippertjes	kippetjes	replacement	1
kipper	kippen	replacement	1
horloos	horloge	replacement	1
le	lezen	noncompletion	1
pannestoelen	paddestoelen	replacement	1
ree	reed	noncompletion	1
fornhuis	fornuis	replacement	3
poe	poes	noncompletion	1
pandarijntjes	mandarijntjes	replacement	1
houen	houden	noncompletion	11
purels	puzzels	replacement	1
effies	eventjes	replacement	2
schijfpennen	schrijfpennen	noncompletion	1
schijfpen	schrijfpen	noncompletion	1
aanstokke	tandenstoker	replacement	1
schijven	schrijven	noncompletion	1
vul	veel	replacement	1
hem	heb	replacement	6
watte	natte	replacement	1
doorsnijen	doorsnijden	noncompletion	2
kingen	gingen	replacement	1
trat	dat	replacement	1
k	gek	noncompletion	1
apie	aapje	replacement	1
kappiechon	capuchon	replacement	3
gezeg	gezegd	noncompletion	1
pobeer	probeer	noncompletion	1
d'rdoor	erdoor	replacement	4
jè	ja	replacement	1
Tinks	Tinke	replacement	1
breeje	brede	replacement	1
ne	de	replacement	1
opdraaiden	omdraaien	replacement	1
t'raf	eraf	replacement	1
mdat	omdat	noncompletion	1
vezorg	bezorgd	replacement	1
gaaien	gooien	replacement	1
gil	ging	replacement	1
ahhu	anders	replacement	1
de	ze	replacement	1
woude	wouden	noncompletion	1
donker	donkergroen	noncompletion	1
slingersjes	slingertjes	replacement	1
a	ja	noncompletion	1
f	of	noncompletion	1
ku	kunnen	noncompletion	1
se	de	replacement	1
legd	gelegd	noncompletion	1
steren	luisteren	noncompletion	1
vrouwen	mevrouwen	noncompletion	1
blager	slager	replacement	1
peciaal	speciaal	noncompletion	1
gee	geef	noncompletion	1
omdraai	omdraaien	noncompletion	1
d'rlangs	erlangs	replacement	1
duppeltje	druppeltje	noncompletion	1
bla	blauw	noncompletion	1
tuut	kus	replacement	1
hie	hij	replacement	1
banaa	banaan	noncompletion	1
ge	gepakt	noncompletion	1
d'rtegen	ertegen	replacement	1
krijden	krijtjes	replacement	1
tekewe	tekenen	replacement	2
ne	we	replacement	2
teke	tekenen	replacement	1
koekie	koekje	replacement	3
it	dit	noncompletion	1
r	waar	noncompletion	1
thuig	thuis	replacement	1
hierof	hierop	replacement	1
pnieuw	opnieuw	noncompletion	1
meegenom	meegenomen	noncompletion	1
kie	niet	replacement	1
d'ronderuit	eronderuit	replacement	1
tuwee	twee	replacement	1
t	met	noncompletion	4
zo	zo'n	replacement	1
dier	hier	replacement	1
snijen	snijden	noncompletion	16
hennen	rennen	replacement	1
ammaal	allemaal	replacement	9
opberrugen	opbergen	replacement	1
Liezebeth	Liesbeth	replacement	1
noi	nee	replacement	1
kepeertafel	kampeertafel	replacement	1
wortekje	worteltje	replacement	1
r	weer	noncompletion	1
wa	wassen	noncompletion	1
talweer	alweer	replacement	1
Tink	Tinke	noncompletion	1
glapen	slapen	replacement	1
noog	nodig	replacement	1
stond	verstond	noncompletion	1
viel	veel	replacement	1
nin	in	replacement	1
nt	want	noncompletion	2
pesen	persen	noncompletion	1
over	oven	replacement	8
tuid	tijd	replacement	1
daak	dadelijk	replacement	1
't	komt	replacement	1
pasghetti	spaghetti	replacement	2
gehaktballie	gehaktballetje	replacement	3
jus	lust	replacement	1
mok	maak	replacement	1
gespetti	spaghetti	replacement	1
figuurjes	figuurtjes	replacement	1
d'rbovenop	erbovenop	replacement	3
zeien	zeiden	noncompletion	2
niete	nietes	noncompletion	1
zaat	staat	replacement	1
gos	gossie	replacement	1
steltes	stelten	replacement	1
gedreumd	gedroomd	replacement	1
ja	jij	replacement	1
prikkie	prikje	replacement	2
effen	even	replacement	1
leeuwtie	leeuwtje	replacement	1
allenaa	allemaal	replacement	1
ten	moeten	noncompletion	1
rone	rode	replacement	1
gulder	gulden	replacement	1
geschpeeld	gespeeld	replacement	1
de	er	replacement	2
got	gaat	replacement	1
dreetje	beetje	replacement	1
paraplie	paraplu	replacement	1
theepo	theepot	noncompletion	1
gesmaakteke	smakelijke	replacement	1
schietroen	citroen	replacement	2
srietroen	citroen	replacement	1
srietroenen	citroenen	replacement	1
worre	worden	replacement	1
garoene	groene	replacement	1
derinken	drinken	replacement	1
seb	heb	replacement	1
sgeeft	geeft	replacement	1
zitte	zitten	replacement	1
afgelop	afgelopen	noncompletion	1
kartet	kwartet	noncompletion	1
pspaghetti	spaghetti	replacement	1
pesghetti	spaghetti	replacement	1
glij	glijd	noncompletion	1
krijgt	kijkt	replacement	1
och	toch	noncompletion	1
wiete	witte	replacement	1
pakkies	pakjes	replacement	1
jel	wel	replacement	1
d'd	er	replacement	1
giezelige	griezelige	noncompletion	1
hempje	hemdje	replacement	1
kek	kijk	replacement	1
lampaarnpaa	lantaarnpaal	replacement	1
daarof	daarop	replacement	1
mooi	mooist	noncompletion	1
wegrijen	wegrijden	noncompletion	1
bekkie	bekje	replacement	1
Duitseland	Duitsland	replacement	1
wijfie	wijfje	replacement	1
heemaal	helemaal	noncompletion	2
treuren	kleuren	replacement	1
fo	zo	replacement	1
bladze	bladzij	replacement	1
vasthouen	vasthouden	noncompletion	1
verklejen	verkleden	replacement	2
sen	wassen	noncompletion	1
net	het	replacement	6
zijn	zij	replacement	1
zuwe	zullen	replacement	1
lekkie	lekker	replacement	1
Luc	Lucy	noncompletion	2
missch	misschien	noncompletion	1
usan	Susan	noncompletion	1
san	Susan	noncompletion	1
die	recorder	explanation	1
gewee	geweest	noncompletion	1
luist	luisteren	noncompletion	1
help	helpen	noncompletion	2
&f	vliegtuig	explanation	1
au	auto	noncompletion	2
blade	bladeren	noncompletion	1
opepast	opgepast	noncompletion	1
ges	gespeeld	noncompletion	1
gevon	gevonden	noncompletion	1
boo	boot	noncompletion	1
Jo	Joke	noncompletion	1
ten	opeten	noncompletion	1
bloe	bloed	noncompletion	2
ie	box	explanation	1
kl	klap	noncompletion	1
ee	eerst	noncompletion	1
ater	water	noncompletion	1
jama	pyjama	noncompletion	1
avonde	avondeten	noncompletion	1
kocht	gekocht	noncompletion	5
	ik	explanation	1
vleugs	vleugels	noncompletion	1
verve	vervelend	noncompletion	1
bouwd	gebouwd	noncompletion	11
Doen	Doenja	noncompletion	1
zoekt	gezocht	replacement	1
st	staan	noncompletion	1
maten	tomaten	noncompletion	1
kuss	kussen	noncompletion	1
hi	hier	noncompletion	2
Hei	Hein	noncompletion	1
doel	bedoel	noncompletion	7
gin	begin	noncompletion	1
z	zij	noncompletion	1
uitedaan	uitgedaan	noncompletion	1
	die	explanation	1
lij	lijkt	noncompletion	1
wone	gewone	noncompletion	1
teld	verteld	noncompletion	2
kleid	gekleid	noncompletion	2
paraat	apparaat	noncompletion	1
uitbla	uitblazen	noncompletion	1
grijpen	begrijpen	noncompletion	1
een	sandwich	explanation	1
als	zoals	noncompletion	1
pijn	Pepijn	noncompletion	2
pet	trompet	noncompletion	1
iemand	niemand	explanation	1
ko	komt	noncompletion	1
kin	kinderen	noncompletion	1
staan	verstaan	noncompletion	1
puz	puzzel	noncompletion	1
ie	recorder	explanation	1
zicht	gezicht	noncompletion	1
gro	grote	noncompletion	1
ne	negen	noncompletion	1
snur	slurf	explanation	1
pape	papegaai	noncompletion	1
gebe	gebeurt	noncompletion	1
op	opleggen	noncompletion	1
om	waarom	noncompletion	1
ziektent	muziektent	noncompletion	1
klim	klimmen	noncompletion	1
jaardag	verjaardag	noncompletion	4
sje	zusje	noncompletion	1
zellig	gezellig	noncompletion	2
morgen	gisteren	explanation	1
bijt	ontbijt	noncompletion	1
Loek	Loeki	noncompletion	2
mingo	flamingo	noncompletion	1
hoog	omhoog	noncompletion	2
Loek	Loekie	noncompletion	1
keken	gekeken	noncompletion	2
broodjs	broodjes	noncompletion	1
bui	buiten	noncompletion	2
raf	eraf	noncompletion	9
egvlieg	wegvlieg	noncompletion	1
lekkr	lekker	noncompletion	1
vlinje	vlindertje	noncompletion	1
Loe	Loekie	noncompletion	1
dro	dropje	noncompletion	1
sta	versta	noncompletion	1
n	niet	noncompletion	1
appels	appelsap	noncompletion	1
hebbelen	helpen	explanation	4
trekkertje	cracker	explanation	1
lek	lekker	noncompletion	7
lapen	geslapen	noncompletion	2
gustus	augustus	noncompletion	1
adder	andere	explanation	1
komkom	komkommer	noncompletion	1
loren	verloren	noncompletion	2
droogsteen	schoorsteen	explanation	1
an	kan	noncompletion	1
rozientje	rozijntje	explanation	1
&trɛ	trein	explanation	1
dodozer	bulldozer	explanation	1
t	heeft	noncompletion	1
zijntje	rozijntje	noncompletion	1
lg	vervolg	noncompletion	1
regend	geregend	noncompletion	1
valt	gevalt	noncompletion	2
meegkomen	meegekomen	noncompletion	2
tiek	gymnastiek	noncompletion	1
panje	Spanje	noncompletion	1
metje	meisje	explanation	1
olivaar	ooievaar	explanation	1
kair	keer	explanation	1
verfd	geverfd	noncompletion	2
chil	schil	noncompletion	1
slagen	geslagen	noncompletion	1
Tho	Thomas	noncompletion	1
w	wil	noncompletion	4
lammetje	lampje	explanation	1
toetj	toetje	noncompletion	2
pit	pitten	noncompletion	1
zeeg	veeg	explanation	1
op	door	explanation	1
man	maan	explanation	1
welle	welles	noncompletion	1
Thom	Thomas	noncompletion	1
hebbele	helpen	replacement	1
openmak	openmaken	noncompletion	1
gebe	gebeten	noncompletion	1
Hel	Hella	noncompletion	1
tele	televisie	noncompletion	1
evalt	gevalt	noncompletion	1
zetten	opzetten	noncompletion	2
mor	morgen	noncompletion	1
snoe	snoepje	noncompletion	1
afpak	afpakken	noncompletion	1
Bian	Bianca	noncompletion	1
vasthou	vasthouden	noncompletion	1
geluist	geluisterd	noncompletion	1
f	af	noncompletion	1
word	worden	noncompletion	1
marijn	mandarijn	noncompletion	1
gebl	gebleven	noncompletion	1
meis	meisje	noncompletion	2
ingele	ingelegd	noncompletion	1
geplaag	geplaagd	noncompletion	1
plaagd	geplaagd	noncompletion	1
zonken	gezonken	noncompletion	1
deks	deksel	noncompletion	1
0	pants	explanation	1
lk	melk	noncompletion	1
kindn	kinderen	noncompletion	1
poesj	poesje	noncompletion	5
telev	televisie	noncompletion	1
tuur	stuur	noncompletion	1
soel	stoel	noncompletion	11
paajtje	paardje	replacement	6
boeoek	boek	replacement	1
fuut	vogel	replacement	1
toes	poes	replacement	39
daaj	daar	replacement	7
oppe	hoepla	replacement	1
ijn	konijn	noncompletion	2
hoepe	hoepla	replacement	1
oep	hoepla	noncompletion	3
paajt	paard	replacement	24
paat	paard	replacement	2
kiekie	kiwi	replacement	1
boekie	boekje	replacement	1
oo	olifant	replacement	2
lekke	lekker	noncompletion	9
amaa	allemaal	noncompletion	7
poet	kapot	replacement	1
eetjes	eendjes	replacement	2
eetje	eendje	replacement	1
ee	ezel	replacement	1
potte	kapotte	noncompletion	1
rije	rijen	noncompletion	2
bute	buiten	noncompletion	5
hoepa	hoepla	noncompletion	4
beej	beer	replacement	16
soesje	poesje	explanation	1
baad	bad	replacement	2
ss	is	replacement	1
daaj	daar	explanation	2
ate	water	noncompletion	1
kiek	kijk	replacement	2
so	zo	replacement	123
pa	pappa	noncompletion	1
hont	hond	replacement	3
konij	konijn	noncompletion	2
lepeltj	lepeltje	noncompletion	1
douch	douche	noncompletion	7
paat	bad	replacement	2
rs	anders	noncompletion	1
toesie	poesje	replacement	2
oes	poes	replacement	1
sies	vliegtuig	replacement	4
maa	maan	noncompletion	5
sui	schuitje	replacement	1
beejtje	beertje	replacement	3
sitte	zitten	replacement	101
niet	beertje	replacement	1
fuit	fruit	noncompletion	8
sit	zitten	replacement	1
ets	fiets	explanation	1
kiekiek	kijken	replacement	1
kiekie	kijken	replacement	5
ses	zes	replacement	4
kieke	kijken	replacement	2
ies	is	replacement	1
aas	kaars	noncompletion	4
kaars	kaars	explanation	1
foefee	vogel	replacement	1
foef	vogel	replacement	1
heejt	heet	replacement	1
suit	schuitje	replacement	1
suitje	schuitje	replacement	2
kiese	kussen	replacement	1
hiej	hier	replacement	2
lese	lezen	replacement	12
beej	beer	explanation	1
toesje	poesje	replacement	12
dese	deze	replacement	102
	Dik	noncompletion	1
ot	kapot	noncompletion	1
huus	huis	replacement	1
saapt	slaapt	noncompletion	2
doe	dag	explanation	1
doei	dag	explanation	1
Bet	Bert	noncompletion	3
an	van	noncompletion	1
saap	slaap	noncompletion	14
sape	slapen	noncompletion	12
hoo	hoor	noncompletion	9
soee	stoelen	noncompletion	1
oes	poes	noncompletion	2
eee	een	replacement	1
keej	keer	replacement	5
bees	beetje	replacement	1
keej	keer	explanation	1
kiwe	kiwi	replacement	2
peej	peer	replacement	1
wes	weg	replacement	5
dah	dag	replacement	2
ksje	kusje	noncompletion	1
daa	dag	replacement	1
ksj	kusje	noncompletion	1
pakkie	pakje	replacement	4
kee	keer	noncompletion	10
pierje	papiertje	noncompletion	1
iert	papiertje	noncompletion	1
aner	ander	noncompletion	5
klaai	klaar	replacement	5
suit	snuit	noncompletion	1
poepe	poepen	noncompletion	11
soe	stoel	noncompletion	2
sap	slab	replacement	2
bere	beren	noncompletion	8
ge	ga	replacement	1
wates	waters	noncompletion	1
zas	zachtjes	replacement	1
douch	douchen	noncompletion	1
moo	mooi	noncompletion	9
mooe	mooie	noncompletion	4
pee	peer	noncompletion	3
ie	ia	replacement	1
gait	geit	replacement	1
sis	vis	replacement	4
ui	uil	noncompletion	1
mon	molen	noncompletion	1
tuit	stuit	noncompletion	1
suis	vliegtuig	replacement	12
vliesuis	vliegtuig	replacement	1
singe	zingen	replacement	2
heije	huilen	replacement	2
root	groot	noncompletion	1
mauwe	mauwen	noncompletion	1
boemen	bloemen	noncompletion	14
bak	zandbak	noncompletion	2
sjonge	tsjonge	noncompletion	1
teek	tekenen	replacement	2
bokken	blokken	noncompletion	10
pejiet	speelgoed	replacement	1
sommel	schommel	noncompletion	2
tommel	schommel	replacement	1
bakke	zandbak	replacement	2
sabakke	zandbak	replacement	2
dous	douche	replacement	3
poeste	poetsen	replacement	1
siets	fiets	replacement	2
ep	heb	replacement	1
teken	tekenen	replacement	1
sok	stok	replacement	2
seit	zegt	replacement	1
suit	zegt	replacement	1
vade	vader	noncompletion	2
Jaco	Jacob	noncompletion	1
was	wassen	noncompletion	1
pank	bank	replacement	1
nos	nog	replacement	5
koei	geknoeid	noncompletion	1
uk	ook	replacement	1
hemme	hebben	replacement	18
toenen	schoenen	replacement	1
eet	eet	replacement	2
sapen	smakelijk	replacement	2
boujen	bouwen	replacement	2
bamme	ballen	explanation	1
rajo	radio	replacement	2
sroot	groot	replacement	1
srote	grote	replacement	1
wat	watten	noncompletion	1
es	eens	replacement	1
Jouwa	Laura	replacement	3
Jouw	Laura	replacement	1
raje	radio	replacement	1
sleut	sleutel	explanation	1
seut	sleutel	noncompletion	1
aarpel	aardappel	noncompletion	4
koke	koken	noncompletion	15
koee	knoeien	noncompletion	2
tasel	tafel	replacement	1
soot	groot	replacement	8
zop	sop	replacement	1
hoe	hoef	noncompletion	10
saate	smakelijk	replacement	2
lesen	lezen	replacement	4
sork	vork	replacement	1
sas	vast	replacement	2
kamme	kammen	noncompletion	11
haarjes	haartjes	noncompletion	2
lepe	lepel	noncompletion	4
seep	zeep	replacement	2
zepezop	zeepsop	replacement	1
oo	oor	noncompletion	2
boeme	bloemen	noncompletion	2
duivesap	druivesap	noncompletion	1
suit	fruit	replacement	3
hane	handen	noncompletion	3
dinken	drinken	noncompletion	1
ceche	creche	noncompletion	3
soet	goed	replacement	1
sanbak	zandbak	replacement	1
soo	schoon	noncompletion	1
koken	kopen	replacement	3
kere	kleren	noncompletion	1
kleren	kleren	replacement	1
passe	plassen	noncompletion	1
haje	haren	replacement	1
ceme	creme	noncompletion	11
ee	keer	noncompletion	1
amme	armen	replacement	1
poee	poeder	noncompletion	2
poede	poeder	noncompletion	1
zich	gezicht	noncompletion	1
poeer	poeder	noncompletion	2
ob	op	replacement	1
sokke	sokken	noncompletion	5
əpa	gepakt	replacement	2
pa	gepakt	replacement	1
rooe	rode	replacement	1
mooi	mooie	noncompletion	2
annere	andere	replacement	1
roje	rode	replacement	1
daje	draadje	replacement	1
eer	keer	noncompletion	1
waat	water	replacement	1
boem	bloemen	noncompletion	2
kimme	klimmen	noncompletion	2
suisje	vliegtuig	explanation	2
sssnon	zon	replacement	1
siesuis	vliegtuig	explanation	7
oos	oog	replacement	3
op	weg	replacement	1
bam	bal	replacement	8
sembad	zwembad	replacement	6
sgau	gauw	replacement	1
hehe	heb	replacement	1
rijstbij	rijstebrij	noncompletion	1
sulle	smullen	noncompletion	1
soor	voor	replacement	1
pannestoel	paddestoel	replacement	3
panne	paddestoel	replacement	1
kom	krom	noncompletion	1
manesijn	maneschijn	noncompletion	3
res	recht	replacement	2
sommel	schommelen	noncompletion	3
hoep	hoepla	noncompletion	15
sommele	schommelen	noncompletion	1
suitje	schuitje	noncompletion	1
tom	kom	replacement	1
sauw	gauw	replacement	1
soo	voor	replacement	1
Hajjie	Harrie	replacement	1
soene	schoenen	noncompletion	5
emij	emmer	replacement	2
ande	ander	noncompletion	4
sont	grond	replacement	1
anner	andere	replacement	1
soepie	soepje	replacement	1
vrastauto	vrachtauto	replacement	1
boseop	bovenop	replacement	6
fa	van	replacement	2
daana	daarna	noncompletion	1
bouwe	bouwen	noncompletion	13
saks	straks	noncompletion	1
boos	bovenop	replacement	1
boo	bovenop	replacement	2
sits	zitten	replacement	1
seppe	scheppen	noncompletion	1
sjep	schep	replacement	1
jee	jij	replacement	7
maak	maken	replacement	1
hiein	hierin	noncompletion	1
baas	blaas	noncompletion	1
blaas	blazen	replacement	1
mijna	bijna	replacement	2
sien	zien	replacement	3
klaa	klaar	noncompletion	11
slaapliets	slaapliedje	replacement	1
foor	voor	replacement	2
bensebij	rijstebrij	replacement	1
heer	heerlijk	replacement	1
se	zo	replacement	1
stakje	strakjes	noncompletion	1
nə	naar	replacement	3
Nienk	Nienke	noncompletion	1
beeje	baby	replacement	2
beeja	baby	replacement	1
roewe	roeren	replacement	1
baar	waar	replacement	1
baa	daar	replacement	2
fan	van	replacement	4
tosje	kopje	replacement	5
tosj	kopje	replacement	1
sik	stik	noncompletion	2
kak	straks	replacement	1
sikke	stikken	noncompletion	1
sit	zit	replacement	1
koeie	knoeien	explanation	2
sis	tas	explanation	1
hemme	hebben	explanation	10
oo	ook	explanation	18
dis	dicht	explanation	5
sese	geven	explanation	1
douche	douchen	explanation	1
eikjeeje	aankleden	explanation	2
soet	goed	explanation	3
Jouwa	Laura	explanation	1
Nuunke	Nienke	explanation	1
siese	vliegtuig	explanation	1
svaje	varen	explanation	1
paajt	paard	explanation	1
hoes	hoef	explanation	1
lus	lucht	explanation	1
sase	jarig	explanation	1
Imm	Irma	explanation	1
sesse	flesje	explanation	1
koke	kopen	explanation	1
sesje	flesje	explanation	2
mees	beest	explanation	1
deuw	deur	explanation	1
kimmek	klimrek	explanation	2
bose	boven	explanation	1
mek	melk	explanation	1
bet	bed	explanation	1
djie	drie	explanation	1
lust	lucht	explanation	1
kitjes	kindjes	explanation	1
zak	zakdoek	explanation	1
semme	zwemmen	explanation	1
beejie	baby	explanation	2
neer	meneer	explanation	2
mesouw	mevrouw	explanation	1
esouw	mevrouw	explanation	1
doese	douchen	explanation	3
oos	ook	explanation	1
oos	over	explanation	1
sose	vogels	explanation	1
toep	stoep	explanation	1
soet	voet	explanation	2
no	nog	explanation	19
soon	schoon	explanation	2
hante	handen	explanation	1
rest	recht	explanation	1
sooit	gooit	explanation	1
soto	foto	explanation	1
Bejie	Berry	explanation	2
bejie	baby	explanation	1
beejes	baby	explanation	1
beeje	baby	explanation	4
bees	baby	explanation	1
been	baby	explanation	8
fouw	vrouw	explanation	2
sote	grote	explanation	9
tussak	rugzak	explanation	1
saapsak	slaapzak	explanation	1
Bej	Berry	explanation	1
beenie	baby	explanation	1
seese	geweest	explanation	1
leese	lezen	explanation	1
dok	donker	explanation	1
donke	donker	explanation	2
beeb	baby	explanation	3
Non	Manon	explanation	3
uis	uit	explanation	1
heese	lezen	explanation	1
dies	dicht	explanation	2
faan	gevallen	explanation	1
mas	mag	explanation	4
tei	trein	explanation	1
fat	zwart	explanation	1
somake	schoonmaken	explanation	1
dinke	drinken	explanation	1
bijn	bijna	explanation	1
soele	stoelen	explanation	1
nas	nat	explanation	2
fas	vast	explanation	3
mont	mond	explanation	5
moet	moet	explanation	1
moot	mond	explanation	2
oos	oog	explanation	3
baajt	baard	explanation	1
buine	bruine	explanation	1
bauwe	blauwe	explanation	2
soen	groen	explanation	3
donker	blauw	explanation	1
bouwe	bouwen	explanation	1
kie	knie	explanation	3
siets	fiets	explanation	1
ebouter	kabouter	explanation	1
boute	kabouter	explanation	1
sauw	gauw	explanation	1
Jaura	Laura	explanation	2
Jauwa	Laura	explanation	1
raa	raam	explanation	1
neer	neerleggen	explanation	1
teek	tekenen	explanation	1
rooje	rollen	explanation	1
geew	geel	explanation	1
keseew	geel	explanation	1
brauwe	blauwe	explanation	1
brauw	blauw	explanation	1
tjoen	groen	explanation	1
hooje	rollen	explanation	1
terei	trein	explanation	1
tikje	strikje	explanation	2
neezette	neerzetten	explanation	2
hoo	hoor	explanation	1
aaio	radio	explanation	1
aai	radio	explanation	1
daanse	dansen	explanation	1
toesie	poesje	explanation	1
annere	ander	explanation	1
bromme	brommer	explanation	1
boes	bus	explanation	1
trik	strik	explanation	3
trihik	strik	explanation	1
haaje	draaien	explanation	1
dhaaje	draaien	explanation	1
falt	valt	explanation	1
siesap	sinaasappelsap	explanation	1
weh	wel	explanation	1
sij	schillen	explanation	1
wej	weer	explanation	1
sase	schuiven	explanation	1
se	voor	explanation	1
peljtje	spelletje	explanation	1
Sik	Silke	explanation	1
Sakine	Jacqueline	explanation	2
Sakien	Jacqueline	explanation	1
kientje	kindje	explanation	1
va	val	explanation	2
toppe	verstoppen	explanation	4
suise	schuiven	explanation	2
sijtje	slijpen	explanation	1
stikje	strikje	explanation	1
peeje	spelen	explanation	1
self	zelf	explanation	1
pusse	puzzel	explanation	4
tunne	tunnel	explanation	1
e	er	explanation	1
poele	spoelen	explanation	1
wi	wil	explanation	1
me	met	explanation	10
ammaa	allemaal	explanation	1
pulle	spullen	explanation	1
wasse	wachten	explanation	3
eer	eerst	explanation	1
kebome	kerstboom	explanation	1
moek	moeilijk	explanation	2
takauto	tankauto	explanation	1
ka	kan	explanation	2
mneer	meneer	explanation	2
soot	groot	explanation	1
soepes	snoepjes	explanation	1
sokola	chocola	explanation	1
same	samen	explanation	1
moeke	moeilijk	explanation	1
Boee	Buren	explanation	1
soepje	snoepje	explanation	1
soep	snoep	explanation	1
makke	makkelijk	explanation	1
eise	eigen	explanation	1
saan	slaan	explanation	1
moes	moet	explanation	1
keine	kleine	explanation	1
amme	allemaal	explanation	3
ssonmake	schoonmaken	explanation	1
wes	weg	explanation	6
nos	nog	explanation	9
stoute	stouterd	explanation	1
maa	maar	explanation	1
meew	meer	explanation	1
boo	boot	explanation	1
spele	spelen	explanation	1
letjes	lettertjes	explanation	1
jaas	jarig	explanation	1
fie	vies	explanation	1
wannewase	wandelwagen	explanation	3
ewas	gewassen	explanation	1
sosijn	zonneschijn	explanation	1
kee	geen	explanation	1
oosjes	oogjes	explanation	2
joge	yoghurt	explanation	1
ep	heb	explanation	1
koeipot	knoeipot	explanation	1
e	een	explanation	4
peiste	pleister	explanation	1
uitkeje	uitkleden	explanation	1
uikeje	uitkleden	explanation	1
seef	geef	explanation	2
paatjes	plantjes	explanation	1
litje	lichtje	explanation	1
ligje	lichtje	explanation	1
maak	gemaakt	explanation	1
so	zo	explanation	1
krope	knopen	explanation	1
drase	dragen	explanation	3
ammel	allemaal	explanation	1
Him	Wim	explanation	1
kiebe	kriebelen	explanation	1
passe	plasje	explanation	1
fies	fiets	explanation	1
draas	dragen	explanation	1
kaarmake	klaarmaken	explanation	1
he	heb	explanation	2
we	wel	explanation	2
sotbel	snottebel	explanation	1
moeluk	moeilijk	explanation	1
meenome	meenemen	explanation	1
he	het	explanation	1
me	we	explanation	1
Buwe	Buren	explanation	1
mose	morgen	explanation	4
seiltje	zelf	explanation	2
kampietje	kammetje	explanation	1
morse	morgen	explanation	1
dokke	dokter	explanation	1
kese	gekregen	explanation	1
pannes	spannend	explanation	1
mase	mag	explanation	1
mose	mocht	explanation	1
mee	meer	explanation	2
kasje	kwastje	explanation	3
kas	kwast	explanation	1
sakjes	strakjes	explanation	3
taaf	tafel	explanation	1
sooie	gooien	explanation	1
omsooie	omgooien	explanation	2
selfe	zelfde	explanation	1
seefe	zelfde	explanation	2
sreefe	zelfde	explanation	1
rus	rug	explanation	1
posse	kapot	explanation	1
sakkies	strakjes	explanation	1
hoe	hoef	explanation	2
o	op	explanation	1
sool	school	explanation	1
mosse	morgen	explanation	1
sraar	schaar	explanation	1
temaak	gemaakt	explanation	1
seeve	zelfde	explanation	1
krip	knippen	explanation	1
grore	horen	explanation	1
hore	horen	explanation	1
puntje	speentje	explanation	5
onnebroek	onderbroek	explanation	1
beeie	baby	explanation	1
sinke	drinken	explanation	1
toe	doen	explanation	1
jos	yoghurt	explanation	3
hem	hebben	explanation	1
uitholle	uitrollen	explanation	1
le	leg	explanation	1
foor	van	explanation	5
lasse	lachen	explanation	1
sehoog	omhoog	explanation	1
semenede	beneden	explanation	1
kos	gekocht	explanation	1
koch	gekocht	explanation	1
sevraagt	gevraagd	explanation	1
driets	drie	explanation	1
lesse	leggen	explanation	2
pinekaas	pindakaas	explanation	1
amma	allemaal	explanation	1
schommetjes	schommeltjes	explanation	1
slad	glad	explanation	1
koei	knoei	explanation	1
schoo	gooien	explanation	1
falle	gevallen	explanation	1
fas	van	explanation	1
naa	naar	explanation	1
gis	gisteren	explanation	1
een	een	explanation	1
keie	kleien	explanation	1
meeje	beneden	explanation	1
krijse	krijgen	explanation	1
omme	onder	explanation	1
sgoot	groot	explanation	1
sespeel	gespeeld	explanation	1
grose	grote	explanation	1
eis	eigenlijk	explanation	2
wase	wagen	explanation	3
hoos	hoog	explanation	2
kres	creche	explanation	2
siekehuis	ziekenhuis	explanation	1
wegrenne	wegbrengen	explanation	1
trie	drie	explanation	1
puus	puzzels	explanation	1
droos	droog	explanation	1
mos	morgen	explanation	2
asteop	achterop	explanation	1
ekos	gekocht	explanation	1
slus	vlug	explanation	2
ekrees	gekregen	explanation	1
krees	gekregen	explanation	1
nefrou	mevrouw	explanation	1
egaan	weggegaan	explanation	1
sgroene	groene	explanation	1
sgisere	gisteren	explanation	3
saksjes	straks	explanation	1
woon	gewoon	explanation	4
segooit	gegooid	explanation	1
mnede	beneden	explanation	1
jaris	jarig	explanation	1
sij	haar	explanation	1
meee	beneden	explanation	1
vrase	vragen	explanation	1
ewaar	bewaren	explanation	1
hans	hand	explanation	1
tos	toch	explanation	1
sgefe	gegeven	explanation	1
piertje	papiertje	explanation	1
deselfe	dezelfde	explanation	1
schrakjes	strakjes	explanation	1
bos	box	explanation	1
sames	samen	explanation	2
schraks	straks	explanation	1
mog	morgen	explanation	1
sesse	zeggen	explanation	1
opeset	opgezet	explanation	1
es	echt	explanation	1
sisse	voorzichtig	explanation	1
sgisses	gisteren	explanation	1
poep	pop	explanation	1
lessen	leggen	explanation	1
zeffe	zelfde	explanation	1
zelve	zelfde	explanation	1
viltje	velletje	explanation	1
sorten	schort	explanation	1
sort	schort	explanation	1
sot	schort	explanation	1
xxx	volgens	explanation	1
meenemen	meegenomen	explanation	1
ose	open	explanation	1
kieke	drinken	explanation	1
jonnen	pionnen	explanation	1
neu	nee	explanation	1
versteld	verteld	explanation	1
zessen	zeggen	explanation	1
veerbeesjes	lieveheersbeestjes	explanation	1
wrom	waarom	explanation	1
paas	paars	explanation	3
mistuur	ceintuur	explanation	1
metuur	ceintuur	explanation	1
sese	deze	replacement	1
pope	vogel	replacement	1
eet	eend	replacement	3
di	dicht	noncompletion	2
Auwa	Laura	replacement	4
Wauwa	Laura	replacement	20
Waua	Laura	replacement	1
kietele	kietelen	noncompletion	2
oot	schoot	noncompletion	1
zidde	zitten	replacement	1
breje	brede	replacement	2
doe	doei	noncompletion	1
daa	daag	noncompletion	16
kuke	keuken	replacement	1
tasj	tas	replacement	1
toesj	poes	replacement	1
jiesə	vliegtuig	replacement	1
boep	boek	replacement	1
ees	deze	replacement	1
eed	eend	noncompletion	4
oos	ook	replacement	1
bofe	boven	replacement	2
nede	beneden	noncompletion	2
bofen	boven	replacement	1
hem	hebben	replacement	1
sisse	zitten	replacement	5
eedje	eendje	noncompletion	8
eetj	eentje	noncompletion	3
vasthouwen	vasthouden	replacement	1
toot	schoot	replacement	2
foefe	voeten	replacement	2
hoepi	hoepla	replacement	1
tuit	stout	replacement	1
dis	dicht	replacement	3
dik	dicht	replacement	1
ich	dicht	noncompletion	3
icht	dicht	noncompletion	1
fiete	fietsen	noncompletion	2
po	kapot	noncompletion	1
beetje	beertje	noncompletion	6
koekoe	koek	replacement	1
koek	doek	replacement	1
koke	vogel	replacement	4
ko	koe	replacement	1
kokel	vogel	replacement	3
bip	kip	replacement	1
tuig	vliegtuig	noncompletion	4
kogel	vogel	replacement	7
paajt	schildpad	replacement	1
af	giraf	noncompletion	16
kieke	fietsen	replacement	6
fiese	fietsen	noncompletion	3
kietse	fietsen	replacement	7
kieje	fietsen	replacement	1
kinje	kindje	noncompletion	1
titte	zitten	replacement	1
moem	bloem	replacement	5
bom	ballon	replacement	2
kiete	fietsen	replacement	1
dache	kachel	replacement	1
ties	vies	replacement	1
ogel	vogel	noncompletion	3
eendj	eendje	noncompletion	2
aa	aai	noncompletion	5
kieke	kiekeboe	noncompletion	2
koekoo	kiekeboe	replacement	1
blom	ballon	replacement	1
taart	staart	noncompletion	2
kaa	klaar	noncompletion	3
koet	koek	replacement	1
Jaja	Laura	replacement	1
kui	buik	replacement	1
kuik	buik	replacement	7
epak	gepakt	noncompletion	1
diese	deze	replacement	1
toesjes	poesjes	replacement	2
fietse	fietsen	noncompletion	5
pip	kip	replacement	21
puis	muis	replacement	2
kak	krak	noncompletion	1
fogel	vogel	replacement	6
tikke	tikken	noncompletion	1
foge	vogel	replacement	4
pas	plas	noncompletion	1
tane	tanden	noncompletion	1
oe	oren	noncompletion	2
auw	wauw	noncompletion	1
boem	bloem	noncompletion	3
nijntje	konijntje	noncompletion	50
worsel	wortel	replacement	1
teutel	wortel	replacement	3
totel	wortel	replacement	2
pat	bad	replacement	1
bam	ballon	replacement	2
peltje	spelletje	noncompletion	2
nijnt	konijntje	noncompletion	1
pap	pappa	noncompletion	2
Laja	Laura	replacement	2
hoet	goed	replacement	3
hondj	hondje	noncompletion	2
kiege	spiegel	replacement	1
kuge	spiegel	replacement	1
biese	fietsen	replacement	1
huie	huilen	noncompletion	3
uie	huilen	noncompletion	1
Lauwa	Laura	replacement	1
muisj	muisje	noncompletion	1
Laua	Laura	noncompletion	10
zachies	zachtjes	replacement	1
falle	gevallen	replacement	10
tus	kus	replacement	1
oed	goed	noncompletion	1
juie	luier	replacement	2
juije	luier	replacement	1
amme	allemaal	replacement	8
Wau	Laura	replacement	1
futse	fietsen	replacement	2
muintje	muisje	replacement	1
jonkə	jongetje	replacement	1
Poep	Joep	replacement	2
eg	erg	noncompletion	2
moi	mooi	noncompletion	2
kaatje	kaartje	noncompletion	3
kaats	kaartjes	noncompletion	1
haue	huilen	replacement	1
hauwe	huilen	replacement	4
Dada	Sarah	replacement	2
Daja	Sarah	replacement	2
Saja	Sarah	replacement	1
pogel	vogel	replacement	1
kaarje	kaartje	noncompletion	1
kaat	kaart	noncompletion	2
Wauwe	Laura	replacement	1
bogel	vogel	replacement	2
Sala	Sarah	replacement	2
Zara	Sarah	replacement	1
oew	oor	replacement	2
Saa	Saar	noncompletion	1
bap	schaap	replacement	1
paap	schaap	replacement	2
fief	fiets	replacement	1
tac	tractor	noncompletion	1
puzzel	puzzelen	noncompletion	3
puse	puzzelen	replacement	1
pusse	puzzelen	replacement	2
pusse	puzzel	replacement	3
valfe	varken	replacement	1
vars	varken	replacement	1
varse	varken	replacement	1
fis	vis	replacement	2
appe	appel	noncompletion	3
poosj	knoopje	replacement	1
toetje	stoeltje	noncompletion	1
aje	arme	replacement	1
vliese	vliegen	replacement	1
goge	vogel	replacement	1
fiese	vliegen	replacement	1
walfis	walvis	replacement	2
fliegt	vliegt	replacement	1
fliese	vliegen	replacement	1
flieg	vlieg	replacement	1
t	dit	noncompletion	1
lantje	lammetje	replacement	1
aitje	eendje	replacement	1
kijn	konijn	noncompletion	1
bille	billen	noncompletion	2
ztaan	staan	replacement	1
ammele	schommelen	replacement	1
fuitje	schuitje	replacement	3
efe	even	replacement	7
pape	slapen	replacement	2
tuitje	schuitje	replacement	2
nijntj	konijntje	noncompletion	2
alleme	allemaal	replacement	1
farkj	varkentje	replacement	1
farketje	varkentje	replacement	1
fantje	olifantje	noncompletion	1
afalle	gevallen	replacement	1
eew	leeuw	replacement	1
ijsjebeer	ijsbeer	replacement	1
ijbeer	ijsbeer	noncompletion	1
daaie	draaien	noncompletion	3
Ljoep	Joep	replacement	1
daaheen	daarheen	noncompletion	2
saap	schaap	noncompletion	1
soen	schoen	noncompletion	3
tusse	kussen	replacement	1
kiet	kietel	noncompletion	2
hoppe	hoppen	noncompletion	1
zontje	zonnetje	noncompletion	1
bosing	botsing	noncompletion	1
Laure	Laura	replacement	2
Lau	Laura	noncompletion	6
peldje	speldje	noncompletion	2
peld	speld	noncompletion	2
slag	slang	noncompletion	1
sang	slang	noncompletion	3
pin	spin	noncompletion	4
finde	vlinder	replacement	1
sim	spin	replacement	2
sla	slang	noncompletion	2
soeke	zoeken	replacement	7
kuim	kruimel	noncompletion	2
anner	ander	replacement	2
bom	brom	noncompletion	2
dat	datum	noncompletion	1
daats	datum	replacement	1
semme	zwemmen	replacement	11
foet	voet	replacement	1
koekkok	koekoeksklok	replacement	1
bok	klok	replacement	3
huil	huilen	noncompletion	1
kuiketje	kuikentje	noncompletion	1
varkentj	varkentje	noncompletion	1
vakentje	varkentje	noncompletion	1
kijt	kwijt	noncompletion	2
harstikke	hartstikke	noncompletion	1
ajebei	allebei	replacement	1
grave	graaf	replacement	2
Saba	Sarah	replacement	1
tekenings	tekeningen	replacement	1
sta	staan	noncompletion	1
fuit	fluit	noncompletion	5
Sylve	Sylvia	replacement	4
Sylv	Sylvia	noncompletion	2
batje	balletje	noncompletion	4
boetje	bloemetje	noncompletion	1
teke	getekend	noncompletion	1
tekenen	getekend	replacement	1
Sulve	Sylvia	replacement	1
puzze	puzzelen	noncompletion	2
anners	anders	replacement	2
kante	kranten	noncompletion	2
zwaaie	zwaaien	noncompletion	1
saaien	zwaaien	replacement	1
leggen	liggen	replacement	5
dichə	dicht	replacement	1
boemtje	bloemetje	noncompletion	1
uithale	uithalen	noncompletion	1
kleur	kleurtjes	noncompletion	2
bom	bromfiets	noncompletion	1
boemetje	bloemetje	noncompletion	1
nique	Monique	noncompletion	2
bolles	bolletje	replacement	2
weggelope	weggelopen	noncompletion	2
som	andersom	noncompletion	3
tee	tegen	noncompletion	1
ammersom	andersom	replacement	3
verfe	verven	replacement	1
tukke	stukken	noncompletion	2
vat	valt	noncompletion	2
pelode	potloden	replacement	1
potlode	potloden	noncompletion	1
Lala	Laura	replacement	2
Jacq	Jacqueline	noncompletion	1
amma	allemaal	replacement	9
wunke	winkel	replacement	2
Laue	Laura	replacement	1
ij	ijs	noncompletion	1
hoes	hoef	replacement	1
top	kop	replacement	2
zee	zeer	noncompletion	10
ophouwen	ophouden	replacement	1
Frankkijke	Frankrijk	replacement	2
Laur	Laura	noncompletion	3
opelate	openlaten	noncompletion	1
ophouwe	ophouden	replacement	8
gond	grond	noncompletion	1
Kliniklaas	Sinterklaas	replacement	1
Sintniklaas	Sinterklaas	replacement	1
pelle	spelletje	noncompletion	1
Klinniklaas	Sinterklaas	replacement	2
mole	molen	noncompletion	10
ak	ik	replacement	1
voeltje	vogeltje	noncompletion	1
uile	uilen	noncompletion	5
aflope	afgelopen	noncompletion	9
nijntjes	konijntjes	noncompletion	4
vogetje	vogeltjes	noncompletion	1
vogelt	vogeltje	noncompletion	1
palaplu	paraplu	replacement	2
zondebril	zonnebril	replacement	1
heef	hebt	replacement	1
ə	heb	replacement	1
be	ben	noncompletion	3
donke	donker	noncompletion	6
siraf	giraf	replacement	3
pleise	pleister	noncompletion	1
teppe	steppen	noncompletion	4
oner	onder	noncompletion	1
kaan	kraan	noncompletion	1
eten	gegeten	noncompletion	1
pikt	prikt	noncompletion	1
m	mijn	noncompletion	1
wes	wesp	noncompletion	5
kaate	kaarten	noncompletion	1
soepje	snoepje	noncompletion	2
zonbil	zonnebril	noncompletion	1
faaien	waaien	replacement	1
dieetuin	dierentuin	noncompletion	2
sehbak	zandbak	replacement	1
peeltuin	speeltuin	noncompletion	1
peetuin	speeltuin	noncompletion	4
schomme	geschommeld	noncompletion	1
me	meer	noncompletion	1
kindetes	kindertjes	noncompletion	1
turkje	jurkje	replacement	1
kippe	knippen	noncompletion	1
wrijve	wrijven	noncompletion	1
wortetjes	worteltjes	noncompletion	1
moehe	moeder	replacement	2
epraat	gepraat	noncompletion	1
falle	vallen	replacement	2
niesien	gezien	replacement	1
dieretuine	dierentuinen	noncompletion	1
moge	morgen	noncompletion	5
winket	weekend	replacement	1
winkelt	weekend	replacement	2
falt	valt	replacement	1
kreef	kreeft	noncompletion	1
plaplu	paraplu	replacement	2
se	is	replacement	1
tannepussel	tandenborstel	replacement	1
moog	morgen	replacement	3
geurt	gescheurd	replacement	5
begeurd	gescheurd	replacement	1
res	rest	noncompletion	2
kleurd	gekleurd	noncompletion	4
teentje	steentje	noncompletion	1
schoomake	schoonmaken	noncompletion	1
zanbak	zandbak	noncompletion	8
fi	vind	replacement	1
sak	zak	replacement	5
vies	vieze	replacement	1
fluite	fluiten	noncompletion	5
ape	apen	noncompletion	3
mneer	meneer	noncompletion	12
das	dat	replacement	9
telle	vertellen	noncompletion	11
vetelle	vertellen	noncompletion	1
sien	gezien	replacement	1
gape	gapen	noncompletion	2
sie	zie	replacement	2
sijn	zijn	replacement	4
onijn	konijn	noncompletion	1
des	deze	replacement	1
daars	daar	replacement	1
gesien	gezien	replacement	2
luile	huilen	replacement	1
bloed	gebloed	replacement	1
valle	gevallen	noncompletion	3
anesom	andersom	noncompletion	3
edaa	gedaan	noncompletion	1
slaa	slaap	noncompletion	2
schaa	schaap	noncompletion	1
soetje	zoetjes	replacement	1
fliegje	vliegje	replacement	2
lieg	vlieg	noncompletion	1
kozijnen	rozijnen	replacement	1
zijnen	rozijnen	noncompletion	1
zijne	rozijnen	noncompletion	1
bak	bakt	noncompletion	1
bets	wesp	replacement	2
korsje	korstje	noncompletion	1
bee	been	noncompletion	2
n	van	noncompletion	1
ebleven	gebleven	noncompletion	1
renne	rennen	noncompletion	2
jasse	jassen	noncompletion	1
liegje	vliegje	noncompletion	1
overdijnen	gordijnen	replacement	1
pulletjes	spulletjes	noncompletion	2
srand	strand	noncompletion	1
stand	strand	noncompletion	1
trand	strand	noncompletion	2
dis	dit	replacement	1
tan	kan	replacement	1
was	wat	replacement	1
nijne	konijnen	noncompletion	1
ka	kar	noncompletion	3
ane	ander	noncompletion	8
waag	wagen	replacement	2
poppehuis	poppenhuis	noncompletion	5
aners	anders	noncompletion	2
slap	slapen	noncompletion	1
verer	verder	noncompletion	1
andes	anders	noncompletion	1
eventj	eventjes	noncompletion	2
anes	anders	noncompletion	2
pussel	puzzel	replacement	5
goene	groene	noncompletion	1
afglijen	afglijden	noncompletion	6
ronrije	rondrijden	noncompletion	1
rondrijen	rondrijden	noncompletion	1
g	ga	noncompletion	1
zaap	slaap	replacement	1
wanele	wandelen	noncompletion	1
ture	sturen	noncompletion	2
turen	sturen	noncompletion	1
sakeijk	smakelijk	noncompletion	1
sake	smakelijk	noncompletion	1
sakel	smakelijk	noncompletion	1
spelle	spelletje	noncompletion	1
pusselen	puzzelen	replacement	1
puzzeljes	puzzeltjes	noncompletion	1
chocomelluk	chocolademelk	replacement	3
toume	stoute	replacement	1
weglope	weglopen	noncompletion	1
tuk	stuk	noncompletion	8
elate	gelaten	noncompletion	1
weglope	weggelopen	noncompletion	1
voorleze	voorlezen	noncompletion	35
Koendrien	Corine	replacement	1
vogel	vogels	noncompletion	1
swaar	schaar	replacement	1
heppe	hebben	replacement	1
tinte	drinken	replacement	2
frou	vrouw	replacement	1
tappe	trappen	noncompletion	1
ap	op	replacement	1
et	het	replacement	1
bip	bips	noncompletion	2
achte	achter	noncompletion	2
taat	taart	noncompletion	1
sjemə	jam	replacement	1
djem	jam	replacement	1
blaflafe	blaffen	replacement	2
mee	meel	noncompletion	1
duu	duur	noncompletion	1
moere	moeder	replacement	1
goria	gloria	noncompletion	5
afope	afgelopen	noncompletion	1
dage	dragen	noncompletion	3
stek	sterk	noncompletion	1
sterruk	sterk	replacement	1
de	die	replacement	2
wach	wachten	noncompletion	2
m	met	noncompletion	1
hep	heb	replacement	3
sjembad	zwembad	replacement	4
el	wel	noncompletion	1
voorlese	voorlezen	replacement	5
debeurt	gebeurt	replacement	2
ə	er	replacement	1
ebeurt	gebeurt	noncompletion	1
mə	maar	replacement	1
nə	je	replacement	1
hanne	handen	replacement	1
juk	jurk	noncompletion	2
bluine	bruine	replacement	1
boererije	boerderijen	replacement	2
boererij	boerderij	replacement	6
oning	honing	noncompletion	1
kroo	kroon	noncompletion	1
afgelope	afgelopen	noncompletion	11
hou	houdt	noncompletion	1
gora	gloria	noncompletion	2
goia	gloria	noncompletion	27
t	die	replacement	1
busse	bussen	noncompletion	1
pringe	springen	noncompletion	1
sembak	zwembad	replacement	1
trugzette	terugzetten	noncompletion	1
puzzele	puzzelen	noncompletion	12
hellepe	helpen	replacement	3
tokjes	stokjes	noncompletion	3
blet	ballet	noncompletion	1
echt	elf	replacement	1
kleke	klepperen	replacement	2
taalf	twaalf	noncompletion	4
pook	spook	noncompletion	10
ra	Laura	noncompletion	1
evalle	gevallen	noncompletion	5
chrijve	schrijven	noncompletion	1
omgooie	omgooien	noncompletion	2
choo	school	noncompletion	1
aankleen	aankleden	noncompletion	1
viete	vieze	replacement	1
verffinger	vingerverf	replacement	1
hamme	handen	replacement	3
tees	vlees	replacement	1
vees	vlees	noncompletion	1
vzichtig	voorzichtig	noncompletion	1
ekregen	gekregen	noncompletion	2
dost	dorst	noncompletion	1
vietjes	viertjes	noncompletion	1
pullebak	prullenbak	noncompletion	1
kleiə	klei	replacement	1
evente	eventjes	noncompletion	1
kleie	kleien	noncompletion	1
opzitte	opzitten	noncompletion	3
koppetje	kopje	replacement	2
taat	staart	noncompletion	3
tedaan	gedaan	replacement	1
Bure	Buren	noncompletion	2
bab	baby	noncompletion	1
Beie	Berrie	noncompletion	1
ens	eens	noncompletion	2
pope	popje	noncompletion	1
Klinklaas	Sinterklaas	replacement	2
Klinterklaas	Sinterklaas	replacement	1
onebroek	onderbroek	noncompletion	3
allema	allemaal	noncompletion	1
one	onder	noncompletion	1
Chrisa	Christa	noncompletion	5
ondebroek	onderbroek	noncompletion	1
mas	mag	replacement	1
Christ	Christa	noncompletion	1
oosjes	oogjes	replacement	2
ookjes	oogjes	replacement	1
boodjes	broodjes	noncompletion	1
pulle	spullen	noncompletion	2
spelaasje	speculaasje	noncompletion	1
staat	staart	noncompletion	2
eatiekje	elastiekje	noncompletion	1
ogegete	opgegeten	noncompletion	1
opgete	opgegeten	noncompletion	5
opgegete	opgegeten	noncompletion	3
lekker	lekkere	noncompletion	2
siek	ziek	replacement	2
tippe	knippen	replacement	2
t	st	noncompletion	2
abbesap	appelsap	replacement	1
paa	paar	noncompletion	1
pleiste	pleister	noncompletion	2
uitpakke	uitpakken	noncompletion	4
washandj	washandje	noncompletion	2
moeje	moetje	noncompletion	1
vader	vaatdoek	replacement	1
vaadoek	vaatdoek	noncompletion	2
sottebel	snottebel	noncompletion	2
brane	branden	noncompletion	1
haat	staat	replacement	1
roetj	rietje	replacement	2
roetje	rietje	replacement	3
opchuive	opschuiven	noncompletion	1
daahee	daarheen	noncompletion	1
rietj	rietje	noncompletion	1
oog	ook	replacement	1
bank	bang	replacement	10
foo	voor	replacement	6
aule	uilen	replacement	1
kokaalkoen	kalkoen	replacement	1
koekoekoen	kalkoen	replacement	1
vaken	varken	noncompletion	2
vak	varken	noncompletion	1
hante	handen	replacement	2
svetjes	servetjes	noncompletion	1
də	dan	replacement	1
monse	monster	noncompletion	2
monte	monster	noncompletion	1
monser	monster	noncompletion	2
opzoeke	opzoeken	noncompletion	6
n	neus	noncompletion	1
peute	peuteren	noncompletion	2
monste	monster	noncompletion	1
uip	luipaard	noncompletion	2
tijge	tijger	noncompletion	1
leeu	leeuw	noncompletion	1
slak	slang	replacement	1
gi	giraf	noncompletion	1
beetj	beetje	noncompletion	1
schille	schillen	noncompletion	1
schon	schone	noncompletion	1
chone	schone	noncompletion	2
opet	opeten	noncompletion	1
netjs	netjes	noncompletion	1
everfd	geverfd	noncompletion	1
epakt	gepakt	noncompletion	1
wassiene	wasmachine	replacement	1
wassienne	wasmachine	replacement	1
opgeget	opgegeten	noncompletion	1
kine	kinderen	noncompletion	2
traks	straks	noncompletion	1
bakte	gebakken	replacement	2
waste	wassen	replacement	2
han	handen	noncompletion	1
opr	opruimen	noncompletion	1
allmaa	allemaal	noncompletion	1
ka	kapot	noncompletion	1
jou	jouw	noncompletion	2
machine	wasmachine	noncompletion	1
wasschiene	wasmachine	replacement	1
kind	kindje	noncompletion	1
kinder	kindje	replacement	1
afgebroke	afgebroken	noncompletion	3
hoor	hoort	noncompletion	4
broke	gebroken	noncompletion	2
asproke	afgesproken	noncompletion	1
husakee	hupsakee	noncompletion	2
michien	misschien	noncompletion	1
afbroke	afgebroken	noncompletion	1
nute	minuten	noncompletion	2
houte	houden	replacement	1
vreke	vreselijke	noncompletion	1
tenen	stenen	noncompletion	1
aktig	acht	replacement	1
uitzoeke	uitzoeken	noncompletion	6
zesetwintig	zesentwintig	noncompletion	1
bwaar	bewaar	noncompletion	3
bware	bewaren	noncompletion	2
	ben	noncompletion	1
maak	gemaakt	noncompletion	9
daz	dat	replacement	1
iz	is	replacement	2
opschrijve	opschrijven	noncompletion	1
poetebal	voetbal	replacement	1
machien	misschien	replacement	1
pbeer	probeer	noncompletion	1
voeballe	voetballen	noncompletion	1
kop	kapot	replacement	1
boere	boerderij	noncompletion	1
boerwij	boerderij	replacement	1
broerwij	boerderij	replacement	1
broewij	boerderij	replacement	1
broere	boerderij	replacement	1
broer	boerderij	replacement	1
boere	boerderij	replacement	1
tukjes	stukjes	noncompletion	3
omruile	omruilen	noncompletion	2
tep	step	noncompletion	1
geten	vergeten	noncompletion	1
ergete	vergeten	noncompletion	1
locomotie	locomotief	noncompletion	1
kalletje	karretje	replacement	1
mt	met	noncompletion	1
schoet	schoen	replacement	1
goens	groen	replacement	1
ranje	randje	noncompletion	1
eenhooa	eekhoorn	replacement	3
eenhoow	eekhoorn	replacement	1
puzze	puzzel	noncompletion	4
edraagt	gedraagt	noncompletion	1
gister	gisteren	noncompletion	2
elegd	gelegd	noncompletion	1
meehepe	meehelpen	noncompletion	4
choot	schoot	noncompletion	3
wegbrenge	wegbrengen	noncompletion	4
helemaa	helemaal	noncompletion	2
slaap	slaapt	noncompletion	2
beve	bever	noncompletion	2
moerer	moeder	replacement	3
afelope	afgelopen	noncompletion	3
miekə	microfoon	replacement	2
telefoon	microfoon	replacement	1
mieke	microfoon	replacement	7
luiste	luister	noncompletion	2
ekoopt	gekocht	replacement	1
koopt	gekocht	replacement	2
rai	rails	noncompletion	1
etopt	verstopt	noncompletion	2
afmake	afmaken	noncompletion	1
goeje	goede	replacement	1
stuke	stukje	noncompletion	1
appesap	appelsap	noncompletion	2
gin	ging	noncompletion	1
dekels	deksel	replacement	1
opt	op	replacement	2
apsap	appelsap	noncompletion	1
appel	appelsap	noncompletion	1
haald	gehaald	noncompletion	5
kukeku	kukeleku	noncompletion	3
swaa	zwaan	replacement	1
vaan	zwaan	replacement	3
zvaan	zwaan	replacement	1
borst	borstel	noncompletion	2
openmake	openmaken	noncompletion	2
werde	werden	noncompletion	1
heddie	herrie	replacement	1
daag	vandaag	noncompletion	2
k	ook	noncompletion	1
kringetj	kringetje	noncompletion	1
kringe	kringetje	noncompletion	1
wager	wagen	replacement	2
deker	deken	replacement	2
te	het	replacement	2
ekrast	gekrast	noncompletion	2
autorije	autorijden	noncompletion	1
schommele	schommelen	noncompletion	2
klimere	klimmen	replacement	1
ringe	ringen	noncompletion	1
ekras	gekrast	noncompletion	1
se	zijn	replacement	3
slijbaan	glijbaan	replacement	3
fsichtig	voorzichtig	replacement	1
slaasje	glaasje	replacement	1
bestesap	bessensap	replacement	1
nies	niet	replacement	1
choentjes	schoentjes	noncompletion	2
pijt	tapijt	noncompletion	1
estoppe	verstoppen	noncompletion	1
sem	jam	replacement	1
fəsta	versta	replacement	1
t	het	replacement	2
affesap	appelsap	replacement	1
besse	bessen	noncompletion	1
bettes	bessen	replacement	1
voorlezen	voorgelezen	noncompletion	1
puzzeld	gepuzzeld	noncompletion	2
iema	iemand	noncompletion	1
verhaa	verhaal	noncompletion	1
zemme	zwemmen	noncompletion	1
kinders	kindertjes	noncompletion	1
sture	sturen	noncompletion	1
pannend	spannend	noncompletion	1
schuime	schuimen	noncompletion	1
sanne	Rosanne	noncompletion	2
tesellug	gezellig	replacement	1
opmake	opmaken	noncompletion	7
opmemaakt	opgemaakt	replacement	1
opma	opmaken	noncompletion	1
eikelijk	eindelijk	replacement	1
peutere	peuteren	noncompletion	1
Pete	Peter	noncompletion	1
kindje	kindjes	noncompletion	1
timmere	timmeren	noncompletion	4
te	de	replacement	4
nijlpaarten	nijlpaarden	replacement	2
ekleurd	gekleurd	noncompletion	2
nijlpaard	nijlpaarden	noncompletion	1
afgeloe	afgelopen	noncompletion	1
hande	handje	noncompletion	1
wegrenne	wegrennen	noncompletion	4
wegerend	weggerend	noncompletion	1
eekhoor	eekhoorn	noncompletion	1
weze	wezel	noncompletion	1
het	hert	noncompletion	1
tekleurd	gekleurd	replacement	1
biebelteek	bibliotheek	replacement	1
biliotheek	bibliotheek	replacement	1
bibiotheek	bibliotheek	noncompletion	2
manetje	mannetje	noncompletion	1
paaplu	paraplu	noncompletion	1
regene	regenen	noncompletion	1
plataplu	paraplu	replacement	1
ki	kind	noncompletion	1
egeven	gegeven	noncompletion	1
ebroke	gebroken	noncompletion	1
nele	Lena	replacement	1
mose	morgen	replacement	1
spettele	spetteren	replacement	2
strikke	strikken	noncompletion	2
pa	papier	noncompletion	1
afedaan	afgedaan	noncompletion	1
knip	knippen	noncompletion	1
zets	zet	replacement	1
zat	zette	replacement	1
tatjes	patatjes	noncompletion	3
ptatjes	patatjes	noncompletion	1
scheure	scheuren	noncompletion	1
tweee	tweeen	noncompletion	1
tofer	tovenaars	replacement	1
afknippe	afknippen	noncompletion	1
koute	koude	replacement	3
geveruf	geverfd	replacement	1
veruf	geverfd	replacement	1
Nie	Nienke	noncompletion	2
Nien	Nienke	noncompletion	1
Da	Dane	noncompletion	2
plakke	plakkertjes	noncompletion	1
hieop	hierop	noncompletion	3
doortrekke	doortrekken	noncompletion	4
plasse	plassen	noncompletion	5
tamer	kamer	replacement	5
batamer	badkamer	replacement	1
hakke	hakken	noncompletion	2
eigewijs	eigenwijs	noncompletion	1
krijte	krijten	noncompletion	1
boererij	boerderij	noncompletion	1
paarte	paarden	replacement	1
schape	schapen	noncompletion	1
vareke	varken	replacement	1
leeuwe	leeuwen	noncompletion	1
hee	heet	noncompletion	3
kokodil	krokodil	noncompletion	1
zeeuwhond	zeehond	replacement	1
zeeuw	zeehond	replacement	1
broteramme	boterhammen	replacement	1
eekhore	eekhoorns	replacement	1
pinakaas	pindakaas	noncompletion	1
krokodille	krokodillen	noncompletion	2
daaro	daarop	noncompletion	1
stapt	gestapt	noncompletion	1
wintik	winkel	replacement	1
melluk	melk	replacement	1
welə	welles	replacement	1
macoroni	macaroni	explanation	1
me	we	replacement	8
macaronien	macaroni	replacement	1
stoppe	verstoppen	noncompletion	1
j	jij	noncompletion	1
losmak	losmaken	noncompletion	1
reuse	reuzen	replacement	1
ie	dier	noncompletion	1
te	er	replacement	2
uigindeluk	uiteindelijk	replacement	1
tr	haar	replacement	2
ertelle	vertellen	noncompletion	1
tel	vertellen	noncompletion	1
zabak	zandbak	noncompletion	1
zadoek	zakdoek	noncompletion	1
ken	kan	replacement	1
koop	koopt	noncompletion	1
evonde	gevonden	noncompletion	1
stieke	stiekem	noncompletion	2
me	meteen	noncompletion	1
ingepak	ingepakt	noncompletion	2
ingepakə	ingepakt	replacement	1
wach	wacht	noncompletion	1
apier	papier	replacement	1
bloe	bloemen	noncompletion	1
oprolle	oprollen	noncompletion	2
tifte	stiften	noncompletion	1
ieman	iemand	noncompletion	1
allee	alleen	noncompletion	1
inepakke	ingepakt	replacement	1
makeroni	macaroni	replacement	1
rond	rondje	noncompletion	2
ronte	rondje	replacement	2
toetereten	toeteren	replacement	1
Donal	Donald	noncompletion	1
etekend	getekend	noncompletion	1
schrijs	schrijft	replacement	1
brootehammetje	boterhammetje	replacement	1
komen	gekomen	noncompletion	4
uitfoetere	uitfoeteren	noncompletion	1
se	ze	replacement	3
voetblalle	voetballen	replacement	1
kante	kanten	noncompletion	2
ronte	ronde	replacement	1
vrouwe	vrouwen	noncompletion	1
wavissen	walvissen	noncompletion	2
zeeme	zeemeermin	replacement	1
schoppe	schoppen	noncompletion	2
slange	slangen	noncompletion	1
schilpatten	schildpadden	replacement	1
kraagvogels	kraanvogels	replacement	3
se	zo'n	replacement	3
slote	gesloten	noncompletion	1
aaie	aaien	noncompletion	4
draaimole	draaimolen	noncompletion	2
mog	mogen	noncompletion	3
broterham	boterham	replacement	3
aangeve	aangeven	noncompletion	1
sglech	slecht	replacement	1
sglecht	slecht	replacement	1
wege	bewegen	noncompletion	1
kopen	gekocht	replacement	1
wit	witte	noncompletion	3
vlokje	vlokjes	noncompletion	1
afkloppe	afkloppen	noncompletion	2
kerms	kermis	noncompletion	1
tijsers	tijgers	replacement	1
ging	gingen	noncompletion	1
uitschrape	uitschrapen	noncompletion	1
broterhammen	boterhammen	replacement	1
Len	Lena	noncompletion	1
wer	werd	noncompletion	1
hagel	hageltjes	noncompletion	1
opschuive	opschuiven	noncompletion	2
kors	korst	noncompletion	2
broo	brood	noncompletion	1
lik	likt	noncompletion	1
gezete	gezeten	noncompletion	1
kosje	korstje	noncompletion	1
happie	hapje	replacement	1
staks	straks	noncompletion	1
uu	uur	noncompletion	3
berge	bergen	noncompletion	1
neerzette	neerzetten	noncompletion	1
feerbeestje	lieveheersbeestje	replacement	1
zellef	zelf	replacement	2
fosichteg	voorzichtig	replacement	1
mij	wij	replacement	1
muize	muizen	noncompletion	1
ene	enen	noncompletion	1
ie	zij	replacement	1
septembder	september	replacement	1
waaie	waaien	noncompletion	2
erteld	verteld	noncompletion	1
ehaaltje	verhaaltje	noncompletion	1
mee	meehelpen	noncompletion	1
brook	brak	replacement	2
brookte	brak	replacement	1
lijme	lijmen	noncompletion	1
Simonste	Simons	replacement	1
ommegooid	omgegooid	replacement	1
pieme	piemel	noncompletion	1
stoppertje	verstoppertje	noncompletion	1
balleke	balken	replacement	1
ertellen	vertellen	noncompletion	1
ehaal	verhaal	explanation	1
parruk	park	explanation	1
ftom	stom	explanation	1
beren	proberen	explanation	1
Kastor	Gaston	explanation	2
falauwekul	flauwekul	explanation	1
ss	zie	replacement	1
ptoffels	pantoffels	explanation	1
dach	dacht	noncompletion	3
openmahaken	openmaken	explanation	1
Wiek	koperwiek	explanation	1
kaasjes	kaarsen	explanation	2
verstel	vertel	explanation	1
kipje	kribje	explanation	1
dee	deed	explanation	1
deesze	deze	explanation	1
dieresaurus	dinosaurus	explanation	1
Bel	Belle	explanation	1
Gastol	Gaston	explanation	1
lenter	lente	explanation	1
en	sen	noncompletion	3
Hajo	Harry	explanation	1
tout	verkouden	explanation	1
postoor	postkantoor	noncompletion	2
broe	broek	noncompletion	1
topies	knoopjes	explanation	1
amme	andere	explanation	1
tainer	container	noncompletion	1
douwe	douwen	noncompletion	1
omvalte	omgevallen	explanation	1
delen	onderdelen	noncompletion	1
	graafmachine	explanation	1
trei	trein	noncompletion	1
bietje	beetje	explanation	1
op+boven	boven	explanation	1
omvallen	omgevallen	noncompletion	6
vrachtaut	vrachtauto	noncompletion	1
brandauto's	brandweerauto's	noncompletion	1
litie	politie	noncompletion	7
nomen	meegenomen	noncompletion	1
gemaakt	geworden	explanation	1
zeeboot	onderzeeboot	noncompletion	1
kapotemaakt	kapotgemaakt	noncompletion	1
aanwagen	aanhangwagen	noncompletion	9
eus	neus	noncompletion	1
snui	snuiten	noncompletion	1
	rode	explanation	1
vloe	vloertje	noncompletion	1
opgehang	opgehangen	noncompletion	1
dakpannen	dak	explanation	1
uitschieten	opschieten	explanation	1
teen	meteen	noncompletion	1
waschine	wasmachine	noncompletion	7
tekend	getekend	noncompletion	4
afpakt	afgepakt	noncompletion	1
hands	handschoen	noncompletion	1
afzaagd	afgezaagd	noncompletion	3
zev	zeven	noncompletion	1
omkeerd	omgekeerd	noncompletion	1
poepoe	pistool	explanation	3
maa	maakt	noncompletion	1
ma	maak	noncompletion	1
dichtmaakt	dichtgemaakt	noncompletion	1
maa	maak	noncompletion	1
hoge	omhoog	explanation	1
ophij	ophijsen	noncompletion	1
opmaakt	opgemaakt	noncompletion	1
chola	chocola	noncompletion	2
laten	gelaten	noncompletion	1
lichies	lichten	explanation	1
weggooid	weggegooid	noncompletion	3
hakie	haakje	explanation	1
wegbre	wegbrengen	noncompletion	1
afhaald	afgehaald	noncompletion	3
vrachtau	vrachtauto	noncompletion	1
losma	losmaken	noncompletion	1
affebreken	afgebroken	explanation	1
loof	geloof	noncompletion	4
bleven	gebleven	noncompletion	1
eentj	eentje	noncompletion	1
mam	mamma	noncompletion	1
batrij	batterij	noncompletion	1
bo	boven	noncompletion	1
uitkom	uitkomen	noncompletion	1
zinepomp	benzinepomp	noncompletion	5
bouw	bouwen	noncompletion	2
afbroken	afgebroken	noncompletion	1
bot	boter	noncompletion	1
botham	boterham	noncompletion	1
rage	garage	noncompletion	2
mantje	mannetje	noncompletion	2
op	opa	noncompletion	1
po	politie	noncompletion	1
reden	gereden	noncompletion	2
benzinepomp	benzine	explanation	1
voor	omdat	explanation	1
bij	naar	explanation	1
terwij	terwijl	noncompletion	1
opgraven	opgegraven	noncompletion	1
nie	Leonie	noncompletion	16
contain	container	noncompletion	1
schoor	schoorsteen	noncompletion	1
pla	plassen	noncompletion	1
tankwa	tankwagen	noncompletion	1
schoorveger	schoorsteenveger	noncompletion	1
vl	vlieger	noncompletion	1
vlie	vlieger	noncompletion	1
sta	station	noncompletion	1
e	eten	noncompletion	2
pi	pizza	noncompletion	1
bou	gebouwd	noncompletion	1
tr	trompet	noncompletion	1
trom	trompet	noncompletion	1
heleb	heleboel	noncompletion	1
afknip	afgeknipt	noncompletion	1
omdr	omdraaien	noncompletion	1
ko	kopen	noncompletion	1
waaro	waarom	noncompletion	2
zeg	gezegd	noncompletion	3
boodschap	boodschappen	noncompletion	1
schappen	boodschappen	noncompletion	1
voor	over	explanation	1
peerzaag	decoupeerzaag	noncompletion	2
zegd	gezegd	noncompletion	2
in	erin	noncompletion	1
neerleg	neerleggen	noncompletion	2
talen	betalen	noncompletion	1
neertje	meneertje	noncompletion	4
tonmolen	betonmolen	noncompletion	2
mage	magere	noncompletion	1
luisterd	geluisterd	noncompletion	1
wieles	wieltjes	noncompletion	1
stomme	stommerd	noncompletion	1
vastmaakt	vastgemaakt	noncompletion	3
litiemannen	politiemannen	noncompletion	1
mannetj	mannetje	noncompletion	1
teken	getekend	noncompletion	1
afsneden	afgesneden	noncompletion	1
strui	struisvogel	noncompletion	1
potmaken	kapotmaken	noncompletion	1
aftekend	afgetekend	noncompletion	1
optekend	opgetekend	noncompletion	2
opteke	optekenen	noncompletion	1
afehaal	afgehaald	noncompletion	1
omt	komt	noncompletion	1
gara	garage	noncompletion	1
omzaag	omgezaagd	noncompletion	1
huiswagen	verhuiswagen	noncompletion	1
afhaal	afgehaald	noncompletion	1
ebouwd	gebouwd	noncompletion	1
rege	regenen	noncompletion	3
vrachtwag	vrachtwagen	noncompletion	1
ton	beton	noncompletion	2
zeten	gezeten	noncompletion	1
ment	cement	noncompletion	1
betonmo	betonmolen	noncompletion	1
boorchine	boormachine	noncompletion	1
ku	kun	noncompletion	1
beerd	geprobeerd	noncompletion	1
tss	limonade	explanation	1
sinappel	sinaasappel	noncompletion	1
landlop	landloper	noncompletion	1
niet	niets	noncompletion	1
omdaan	omgedaan	noncompletion	1
af	eraf	noncompletion	1
opdaan	opgedaan	noncompletion	1
takeld	getakeld	noncompletion	1
meenomen	meegenomen	noncompletion	2
eigen	eigenlijk	noncompletion	1
vasehouden	vastgehouden	noncompletion	1
afesneden	afgesneden	noncompletion	1
&ta	slapen	explanation	1
vangen	gevangen	noncompletion	3
rijs	Parijs	noncompletion	1
waarhee	waarheen	noncompletion	1
meereden	meegereden	noncompletion	1
	opnemen	explanation	1
boormachin	boormachine	noncompletion	1
maat	gemaakt	noncompletion	1
haal	gehaald	noncompletion	1
deerkamer	studeerkamer	noncompletion	1
tuut	fluit	explanation	1
droom	gedroomd	noncompletion	1
gekreg	gekregen	noncompletion	1
lene	Helene	noncompletion	1
beurd	gebeurd	noncompletion	2
daan	vandaan	noncompletion	2
paai	papegaai	noncompletion	1
eens	opeens	noncompletion	1
legen	gelegen	noncompletion	1
heen	doorheen	noncompletion	1
plaa	plaatjes	noncompletion	1
nietje	kogel	explanation	1
takelwag	takelwagen	noncompletion	1
e	es	noncompletion	1
opdroog	opgedroogd	noncompletion	1
afezaag	afgezaagd	noncompletion	1
beert	probeert	noncompletion	1
inemeer	ingesmeerd	noncompletion	1
reedschap	gereedschap	noncompletion	3
re	gereden	noncompletion	1
waschines	wasmachines	noncompletion	1
mnuutje	minuutje	noncompletion	1
wonen	gewonen	noncompletion	1
rages	garages	noncompletion	1
opebouwd	opgebouwd	noncompletion	1
nuutjes	minuutjes	noncompletion	1
peren	kamperen	noncompletion	1
tenne	antenne	noncompletion	1
hoe	waarom	explanation	2
politiegenten	politieagenten	noncompletion	1
aanedaan	aangedaan	noncompletion	1
vastemaakt	vastgemaakt	noncompletion	1
voor	als	explanation	1
voor	zodat	explanation	1
pun	puntje	noncompletion	1
inedaan	ingedaan	noncompletion	2
uitglijen	uitglijden	noncompletion	2
vrieg	vroeg	replacement	1
wi	witte	noncompletion	1
sn	snel	noncompletion	1
aus	uit	replacement	1
hageltje	wagentje	replacement	1
mamamaise	mayonaise	replacement	1
ron	grond	noncompletion	1
begooid	gegooid	replacement	1
salt	valt	replacement	1
Vilola	Viola	replacement	1
get	geeft	replacement	1
wouwen	wilden	replacement	4
bokse	boksen	noncompletion	1
boksen	botsen	replacement	2
bokst	botst	replacement	1
reen	reden	noncompletion	1
opgeete	opgegeten	noncompletion	1
has	had	replacement	1
meissie	meisje	replacement	2
zand	stond	replacement	1
brach	bracht	noncompletion	1
nieuw	nieuwe	noncompletion	1
gebost	gebotst	noncompletion	2
noe	nu	replacement	1
timmelen	timmeren	replacement	1
troosen	troosten	noncompletion	1
trijen	rijden	replacement	1
bosse	botsen	replacement	1
anger	ander	replacement	1
wouen	wouden	noncompletion	2
bosen	botsen	noncompletion	1
teraan	eraan	replacement	1
gorry	sorry	replacement	1
luipen	slopen	replacement	1
kis	kist	noncompletion	1
Je	Jelle	noncompletion	1
doewt	duwt	replacement	1
weggooie	weggooien	noncompletion	1
hum	hij	explanation	1
oppereupt	opgeraapt	replacement	1
gerij	erbij	replacement	1
kindergewagen	kinderwagen	replacement	1
praatje	plaatje	replacement	1
han	hand	noncompletion	1
of	af	replacement	1
meer	meneer	replacement	1
frietse	frietje	replacement	1
trekg	trekt	replacement	1
barron	ballon	replacement	5
er	der	noncompletion	1
nikse	niks	replacement	1
mekocht	gekocht	replacement	1
plos	plots	replacement	1
kapotte	kapot	replacement	1
kwom	kwam	replacement	1
der	er	replacement	3
vrun	vriend	replacement	1
allon	ballon	noncompletion	1
komp	komt	replacement	1
pe	gelopen	replacement	1
spallen	spelen	replacement	1
kinderwage	kinderwagen	noncompletion	2
za	zak	noncompletion	1
hum	zijn	replacement	1
pranken	planken	replacement	1
hum	hun	replacement	1
e	het	replacement	1
e	de	replacement	1
gespaast	verbaasd	replacement	1
om	of	replacement	1
afrijde	afrijden	noncompletion	1
om	omdat	replacement	2
gooidede	gooide	replacement	1
wegvliege	wegvliegen	noncompletion	2
wollen	willen	replacement	1
beis	meisje	replacement	1
derop	erop	replacement	1
graat	gaat	replacement	1
allembei	allebei	replacement	1
voegden	veegden	replacement	1
mayonaide	mayonaise	replacement	1
meije	meisje	replacement	1
belg	berg	replacement	1
stik	stuk	replacement	1
nieuwen	nieuwe	replacement	1
vil	wil	replacement	2
iech	hier	replacement	1
clou	clown	replacement	1
kintewage	kinderwagen	replacement	1
kinnewage	kinderwagen	replacement	1
frie	viel	replacement	1
e	het	noncompletion	3
ballonne	ballon	replacement	1
houw	houden	replacement	1
tsjuus	dag	replacement	1
tatje	patatje	noncompletion	1
eerse	eerste	noncompletion	1
duise	duizend	replacement	1
achter	achteren	noncompletion	1
botse	botsen	noncompletion	1
bost	botst	noncompletion	2
ge	geven	noncompletion	1
wassen	waren	replacement	2
valde	viel	replacement	1
eval	gevallen	noncompletion	1
kelen	keken	replacement	1
kum	haar	explanation	1
gans	heel	replacement	1
te	tegen	noncompletion	1
gong	ging	replacement	1
uitgeglooien	uitgegleden	replacement	1
geleden	uitgegleden	explanation	1
kinderewage	kinderwagen	replacement	2
groeit	goed	replacement	1
glije	glijden	noncompletion	2
derin	erin	replacement	4
hogelijk	ongeluk	replacement	1
hool	haal	replacement	1
der	haar	replacement	5
maggen	mag	replacement	1
wouwe	wilden	replacement	1
planke	planken	noncompletion	1
rijlen	rijden	replacement	1
kwar	kar	replacement	1
boksing	botsen	replacement	2
boksing	botsing	replacement	2
ken	kun	replacement	2
spijker	spijkeren	noncompletion	1
sleed	gleed	replacement	1
kapok	kapot	replacement	2
rijen	rijden	replacement	1
twam	kwam	replacement	1
derover	erover	replacement	1
kwijtgeraak	kwijtgeraakt	noncompletion	1
glee	gleed	replacement	1
deraf	eraf	replacement	1
zing	ging	replacement	4
menen	nemen	replacement	1
meememen	meenemen	replacement	1
w	weg	noncompletion	1
moesen	moesten	noncompletion	2
tiedaan	gedaan	replacement	1
gebakt	gemaakt	replacement	1
duruit	eruit	replacement	1
um	hem	replacement	1
ziejen	zien	replacement	1
struikt	struikelt	noncompletion	2
albei	allebei	noncompletion	1
patate	patatje	noncompletion	1
bot	botsen	noncompletion	1
toenna	daarna	replacement	1
bu	buggy	noncompletion	1
geeten	gegeten	noncompletion	1
vier	hier	replacement	1
vatat	patat	replacement	1
butte	buiten	replacement	1
houtes	houtjes	noncompletion	1
bllon	ballon	noncompletion	1
weggeren	weggerend	noncompletion	1
problemo	probleem	replacement	1
diep	deed	replacement	1
achtenbaan	achtbaan	replacement	1
koken	kopen	explanation	1
wappen	wapperen	noncompletion	1
spijk	spijker	noncompletion	1
slokest	sloop	replacement	1
lef	clown	replacement	1
dr	der	noncompletion	1
zaat	gaat	replacement	1
berk	berg	replacement	1
kapier	papier	replacement	1
prijn	pijn	replacement	1
lar	kar	replacement	1
n	zijn	noncompletion	1
hu	hun	noncompletion	1
sam	samen	noncompletion	1
wouden	wilden	replacement	1
neers	neer	replacement	1
gebragen	gebruiken	replacement	1
roesjen	roetsjen	replacement	1
plankies	plankjes	replacement	1
he	hele	noncompletion	1
zel	zelf	noncompletion	1
